user_id,reading_session,article_id,max_offset,min_offset,offset_difference,relative_time
111,00c29290-338e-42e9-8897-c475c799e1e5,30118783,61,10,51,0
111,00c29290-338e-42e9-8897-c475c799e1e5,30118783,0,0,0,1
111,2684b548-a936-46f8-90d7-3941bb9cd096,30345801,203,5,198,0
111,2684b548-a936-46f8-90d7-3941bb9cd096,30345801,336,0,-336,1
111,2684b548-a936-46f8-90d7-3941bb9cd096,30367210,650,46,604,0
111,2684b548-a936-46f8-90d7-3941bb9cd096,30367210,2674,651,2023,1
111,2684b548-a936-46f8-90d7-3941bb9cd096,30367210,3374,2690,684,2
111,2684b548-a936-46f8-90d7-3941bb9cd096,30367210,4313,3412,901,3
111,2684b548-a936-46f8-90d7-3941bb9cd096,30367210,4314,4314,0,4
111,2684b548-a936-46f8-90d7-3941bb9cd096,30367210,4214,4094,-120,5
111,2684b548-a936-46f8-90d7-3941bb9cd096,30367210,3979,0,-3979,6
111,2684b548-a936-46f8-90d7-3941bb9cd096,30367210,2041,55,1986,7
111,2684b548-a936-46f8-90d7-3941bb9cd096,30367210,4130,2093,2037,8
111,2684b548-a936-46f8-90d7-3941bb9cd096,30367210,4326,4191,135,9
111,2684b548-a936-46f8-90d7-3941bb9cd096,30367210,0,0,0,10
111,8c8d8c80-2f20-4a44-9e12-29742765d49e,30373336,41,21,20,0
111,8c8d8c80-2f20-4a44-9e12-29742765d49e,30373336,155,50,105,228
111,8c8d8c80-2f20-4a44-9e12-29742765d49e,30373336,1042,172,870,235
111,8c8d8c80-2f20-4a44-9e12-29742765d49e,30373336,1425,494,-931,236
111,8c8d8c80-2f20-4a44-9e12-29742765d49e,30373336,478,165,-313,237
111,8c8d8c80-2f20-4a44-9e12-29742765d49e,30370570,163,82,81,0
111,8c8d8c80-2f20-4a44-9e12-29742765d49e,30370570,654,180,474,1
111,8c8d8c80-2f20-4a44-9e12-29742765d49e,30370570,584,0,-584,2
111,a79efb45-0797-4bb2-9d1e-bc8ae9002b2f,30371222,200,0,-200,0
111,a79efb45-0797-4bb2-9d1e-bc8ae9002b2f,30371222,293,5,288,1
111,a79efb45-0797-4bb2-9d1e-bc8ae9002b2f,30371222,702,306,396,2
111,a79efb45-0797-4bb2-9d1e-bc8ae9002b2f,30371222,860,675,-185,3
111,a79efb45-0797-4bb2-9d1e-bc8ae9002b2f,30368103,114,24,90,0
111,a79efb45-0797-4bb2-9d1e-bc8ae9002b2f,30368103,214,0,-214,1
111,7f43cc1a-ee02-409e-bdd3-1464a5dd339a,31534153,365,70,295,0
111,7f43cc1a-ee02-409e-bdd3-1464a5dd339a,31534153,283,0,-283,2
111,c7689cc2-4210-4fd1-9d4b-b8884ce591e9,31532755,304,33,271,0
111,c7689cc2-4210-4fd1-9d4b-b8884ce591e9,31532755,531,0,-531,1
111,c7689cc2-4210-4fd1-9d4b-b8884ce591e9,31532755,0,0,0,2
111,b49e6211-9b6a-432b-bce6-03ea460529d1,31554844,637,0,-637,0
111,b49e6211-9b6a-432b-bce6-03ea460529d1,31554844,794,0,-794,1
111,b49e6211-9b6a-432b-bce6-03ea460529d1,31554844,26,0,-26,2
111,b49e6211-9b6a-432b-bce6-03ea460529d1,31554844,141,31,110,9
111,b49e6211-9b6a-432b-bce6-03ea460529d1,31554844,575,124,451,10
111,b49e6211-9b6a-432b-bce6-03ea460529d1,31554844,1242,609,-633,11
111,b49e6211-9b6a-432b-bce6-03ea460529d1,31554844,1332,580,-752,12
111,b49e6211-9b6a-432b-bce6-03ea460529d1,31554844,1284,0,-1284,13
111,39039618-ec57-4d60-b0c8-097a6811968a,31589202,191,0,-191,0
111,35576f94-f792-4c4d-aef5-f1ca9a53626d,31586980,315,59,256,0
111,35576f94-f792-4c4d-aef5-f1ca9a53626d,31586980,288,0,-288,1
111,35576f94-f792-4c4d-aef5-f1ca9a53626d,31586980,16,0,-16,2
111,35576f94-f792-4c4d-aef5-f1ca9a53626d,31582399,473,36,437,0
111,35576f94-f792-4c4d-aef5-f1ca9a53626d,31585149,9,1,8,0
111,35576f94-f792-4c4d-aef5-f1ca9a53626d,31585149,207,0,207,1
111,35576f94-f792-4c4d-aef5-f1ca9a53626d,31585149,1910,252,1658,2
111,35576f94-f792-4c4d-aef5-f1ca9a53626d,31585149,1864,1765,-99,3
111,35576f94-f792-4c4d-aef5-f1ca9a53626d,31585149,1745,1504,-241,4
111,35576f94-f792-4c4d-aef5-f1ca9a53626d,31585149,1460,574,-886,10
111,35576f94-f792-4c4d-aef5-f1ca9a53626d,31585149,541,0,-541,11
111,35576f94-f792-4c4d-aef5-f1ca9a53626d,31587621,411,54,357,0
111,35576f94-f792-4c4d-aef5-f1ca9a53626d,31587621,915,434,481,2
111,35576f94-f792-4c4d-aef5-f1ca9a53626d,31587621,927,0,-927,3
111,35576f94-f792-4c4d-aef5-f1ca9a53626d,31589202,427,62,365,0
111,35576f94-f792-4c4d-aef5-f1ca9a53626d,31589202,340,0,-340,1
111,35576f94-f792-4c4d-aef5-f1ca9a53626d,31582826,311,42,269,0
111,35576f94-f792-4c4d-aef5-f1ca9a53626d,31582826,502,317,185,1
111,35576f94-f792-4c4d-aef5-f1ca9a53626d,31582826,616,518,98,2
111,35576f94-f792-4c4d-aef5-f1ca9a53626d,31582826,729,628,101,3
111,35576f94-f792-4c4d-aef5-f1ca9a53626d,31582826,1027,741,286,4
111,35576f94-f792-4c4d-aef5-f1ca9a53626d,31582826,971,0,-971,5
111,a6fbba83-556c-4b95-9cf6-76f112ff6cee,31730542,29,1,28,0
111,a6fbba83-556c-4b95-9cf6-76f112ff6cee,31730542,30,30,0,1
111,96ec40d6-3ddc-40d6-b043-a9cb2c2bcbc1,31831857,43,36,7,0
111,96ec40d6-3ddc-40d6-b043-a9cb2c2bcbc1,31831857,453,73,380,1
111,96ec40d6-3ddc-40d6-b043-a9cb2c2bcbc1,31831857,456,454,2,2
111,c0d61561-3f7c-48c6-9f5f-e900c7ec46e4,31832392,273,173,100,0
111,c0d61561-3f7c-48c6-9f5f-e900c7ec46e4,31832392,784,276,508,1
111,c0d61561-3f7c-48c6-9f5f-e900c7ec46e4,31832392,1811,808,1003,2
111,c0d61561-3f7c-48c6-9f5f-e900c7ec46e4,31832392,2276,1504,-772,3
111,c0d61561-3f7c-48c6-9f5f-e900c7ec46e4,31832392,1454,0,-1454,4
111,20208a99-6c52-489c-aa03-8b6f86532360,31835198,1384,294,1090,0
111,20208a99-6c52-489c-aa03-8b6f86532360,31835198,1342,1206,-136,1
111,20208a99-6c52-489c-aa03-8b6f86532360,31835198,1159,0,-1159,2
111,1054b847-a347-4859-85c3-c39ae253659c,31956026,229,0,-229,0
111,de29cda7-59e6-43e3-b469-b7c2be33a4f0,32091020,2200,188,2012,0
111,de29cda7-59e6-43e3-b469-b7c2be33a4f0,32091020,3326,2308,1018,1
111,b8e65d29-1df2-4133-87c9-581828fd0fc3,32083181,3672,159,3513,0
111,b8e65d29-1df2-4133-87c9-581828fd0fc3,32083181,4348,3405,-943,1
111,b8e65d29-1df2-4133-87c9-581828fd0fc3,32083181,3301,0,-3301,2
111,b8e65d29-1df2-4133-87c9-581828fd0fc3,32083181,4348,1583,2765,3
111,b8e65d29-1df2-4133-87c9-581828fd0fc3,32083181,4240,0,-4240,6
111,b8e65d29-1df2-4133-87c9-581828fd0fc3,32083181,868,53,815,10
111,b8e65d29-1df2-4133-87c9-581828fd0fc3,32083181,4348,969,3379,12
111,b8e65d29-1df2-4133-87c9-581828fd0fc3,32083181,4338,4336,-2,13
111,0a00faa2-c867-4d14-a3f3-5e03cb3f87b3,32082660,2080,213,1867,0
111,0a00faa2-c867-4d14-a3f3-5e03cb3f87b3,32082660,2017,88,-1929,1
111,0a00faa2-c867-4d14-a3f3-5e03cb3f87b3,32082660,1043,0,1043,2
111,0a00faa2-c867-4d14-a3f3-5e03cb3f87b3,32082660,1047,0,-1047,3
111,8592e996-3cbb-452c-87b9-c3f467a9a16b,32157686,211,59,152,0
111,8592e996-3cbb-452c-87b9-c3f467a9a16b,32157686,1004,246,758,1
111,8592e996-3cbb-452c-87b9-c3f467a9a16b,32157686,2011,1044,967,2
111,8592e996-3cbb-452c-87b9-c3f467a9a16b,32157686,3012,2032,980,3
111,8592e996-3cbb-452c-87b9-c3f467a9a16b,32157686,4616,3017,1599,4
111,8592e996-3cbb-452c-87b9-c3f467a9a16b,32157686,4539,3168,-1371,5
111,8592e996-3cbb-452c-87b9-c3f467a9a16b,32157686,3154,2616,-538,6
122,97da3dcc-eb6e-428a-b9fb-4fd992e33983,36522510,581,10,571,0
122,97da3dcc-eb6e-428a-b9fb-4fd992e33983,36522510,944,613,331,1
122,97da3dcc-eb6e-428a-b9fb-4fd992e33983,36522510,1083,785,298,3
122,97da3dcc-eb6e-428a-b9fb-4fd992e33983,36522510,1604,1088,516,4
122,97da3dcc-eb6e-428a-b9fb-4fd992e33983,36522510,2040,1614,426,5
122,97da3dcc-eb6e-428a-b9fb-4fd992e33983,36522510,2425,2069,356,6
124,c163ec0f-3639-49ef-b926-1965202de3be,36537821,417,14,403,0
124,c163ec0f-3639-49ef-b926-1965202de3be,36537821,2239,471,1768,1
124,c163ec0f-3639-49ef-b926-1965202de3be,36537821,2828,2263,565,2
124,c163ec0f-3639-49ef-b926-1965202de3be,36537821,2802,1159,-1643,4
124,c163ec0f-3639-49ef-b926-1965202de3be,36537821,1114,496,-618,5
124,c163ec0f-3639-49ef-b926-1965202de3be,36537821,480,98,-382,7
124,c163ec0f-3639-49ef-b926-1965202de3be,36537821,96,47,-49,8
124,c163ec0f-3639-49ef-b926-1965202de3be,36537821,582,77,505,9
124,c163ec0f-3639-49ef-b926-1965202de3be,36537821,778,600,178,10
124,c163ec0f-3639-49ef-b926-1965202de3be,36537821,1104,793,311,11
124,c163ec0f-3639-49ef-b926-1965202de3be,36537821,1594,1108,486,12
124,c163ec0f-3639-49ef-b926-1965202de3be,36537821,2075,1595,480,13
124,c163ec0f-3639-49ef-b926-1965202de3be,36537821,2828,2084,744,14
124,d200eb88-976c-4f8c-86b4-3304e6eb7235,36551464,2064,77,1987,0
124,d200eb88-976c-4f8c-86b4-3304e6eb7235,36551464,2091,0,-2091,1
124,d200eb88-976c-4f8c-86b4-3304e6eb7235,36551464,1388,33,1355,2
124,d200eb88-976c-4f8c-86b4-3304e6eb7235,36551464,1398,1041,-357,3
124,d200eb88-976c-4f8c-86b4-3304e6eb7235,36551464,1013,880,-133,4
124,d200eb88-976c-4f8c-86b4-3304e6eb7235,36551464,1969,904,1065,5
124,d200eb88-976c-4f8c-86b4-3304e6eb7235,36551464,1989,1973,16,6
124,d200eb88-976c-4f8c-86b4-3304e6eb7235,36551464,1967,0,-1967,7
124,513d1613-1f1a-4cec-b619-3840f475df55,36551464,305,5,300,0
124,513d1613-1f1a-4cec-b619-3840f475df55,36551464,1105,337,768,1
124,513d1613-1f1a-4cec-b619-3840f475df55,36551464,1807,1110,697,2
124,513d1613-1f1a-4cec-b619-3840f475df55,36551464,2557,1821,736,3
124,513d1613-1f1a-4cec-b619-3840f475df55,36551464,3058,2570,488,4
124,513d1613-1f1a-4cec-b619-3840f475df55,36551464,3487,3061,426,5
124,513d1613-1f1a-4cec-b619-3840f475df55,36551464,4858,3520,1338,6
124,513d1613-1f1a-4cec-b619-3840f475df55,36551464,5272,4886,386,7
125,b7c0e75f-d9d6-4518-9605-e2d160f37fa4,36514116,234,0,-234,0
125,b7c0e75f-d9d6-4518-9605-e2d160f37fa4,36514116,1430,9,1421,2
125,b7c0e75f-d9d6-4518-9605-e2d160f37fa4,36514116,1494,1376,-118,3
125,b7c0e75f-d9d6-4518-9605-e2d160f37fa4,36514116,1420,1383,37,4
125,b7c0e75f-d9d6-4518-9605-e2d160f37fa4,36514116,2499,1436,1063,5
125,b7c0e75f-d9d6-4518-9605-e2d160f37fa4,36514116,2615,2514,101,6
125,b7c0e75f-d9d6-4518-9605-e2d160f37fa4,36514116,2920,2615,305,11
125,b7c0e75f-d9d6-4518-9605-e2d160f37fa4,36514116,3098,2930,168,12
125,b7c0e75f-d9d6-4518-9605-e2d160f37fa4,36549674,927,36,891,0
125,b7c0e75f-d9d6-4518-9605-e2d160f37fa4,36549674,970,942,28,1
125,b7c0e75f-d9d6-4518-9605-e2d160f37fa4,36549674,1344,983,361,13
125,b7c0e75f-d9d6-4518-9605-e2d160f37fa4,36549674,1633,1345,288,14
125,b7c0e75f-d9d6-4518-9605-e2d160f37fa4,36549674,1714,1635,79,19
125,b7c0e75f-d9d6-4518-9605-e2d160f37fa4,36549674,1864,1715,149,20
125,b7c0e75f-d9d6-4518-9605-e2d160f37fa4,36549674,2014,1890,124,26
125,b7c0e75f-d9d6-4518-9605-e2d160f37fa4,36549674,2331,2021,310,27
125,b7c0e75f-d9d6-4518-9605-e2d160f37fa4,36549674,2476,2268,208,28
125,b7c0e75f-d9d6-4518-9605-e2d160f37fa4,36549674,2699,2483,216,31
125,b7c0e75f-d9d6-4518-9605-e2d160f37fa4,36549674,2986,2710,276,32
125,b7c0e75f-d9d6-4518-9605-e2d160f37fa4,36549674,3561,2988,573,33
125,b7c0e75f-d9d6-4518-9605-e2d160f37fa4,36549674,4284,3600,684,48
125,b7c0e75f-d9d6-4518-9605-e2d160f37fa4,36549674,4690,4291,399,49
125,b7c0e75f-d9d6-4518-9605-e2d160f37fa4,36549674,5754,4723,1031,66
124,0fbe240c-7015-4a2c-8924-735defe18174,36573970,304,15,289,0
124,0fbe240c-7015-4a2c-8924-735defe18174,36573970,1989,320,1669,1
124,0fbe240c-7015-4a2c-8924-735defe18174,36573970,2271,2059,212,2
124,0fbe240c-7015-4a2c-8924-735defe18174,36573970,2253,1320,-933,3
124,0fbe240c-7015-4a2c-8924-735defe18174,36573970,1315,836,-479,4
124,0fbe240c-7015-4a2c-8924-735defe18174,36573970,815,285,-530,5
124,0fbe240c-7015-4a2c-8924-735defe18174,36573970,284,283,-1,6
124,0fbe240c-7015-4a2c-8924-735defe18174,36573970,1333,289,1044,9
124,0fbe240c-7015-4a2c-8924-735defe18174,36573970,2271,1353,918,10
124,0fbe240c-7015-4a2c-8924-735defe18174,36575493,577,4,573,0
124,0fbe240c-7015-4a2c-8924-735defe18174,36575493,1923,595,1328,1
124,0fbe240c-7015-4a2c-8924-735defe18174,36575493,2551,1964,587,2
124,0fbe240c-7015-4a2c-8924-735defe18174,36575493,3162,2575,587,3
124,0fbe240c-7015-4a2c-8924-735defe18174,36575493,3392,3165,227,4
124,0fbe240c-7015-4a2c-8924-735defe18174,36575493,3401,3394,7,5
124,0fbe240c-7015-4a2c-8924-735defe18174,36575493,3493,3407,86,6
124,0fbe240c-7015-4a2c-8924-735defe18174,36575493,3539,3494,45,7
124,0fbe240c-7015-4a2c-8924-735defe18174,36575493,3811,3541,270,8
124,0fbe240c-7015-4a2c-8924-735defe18174,36575493,3979,3815,164,9
124,0fbe240c-7015-4a2c-8924-735defe18174,36575493,4546,3988,558,10
124,0fbe240c-7015-4a2c-8924-735defe18174,36575493,4553,4547,6,20
124,0fbe240c-7015-4a2c-8924-735defe18174,36575493,4894,4555,339,21
124,0fbe240c-7015-4a2c-8924-735defe18174,36575493,5148,4896,252,22
127,bc630298-b14e-431e-a1ef-b39ec6cc385c,36572649,528,4,524,0
127,bc630298-b14e-431e-a1ef-b39ec6cc385c,36572649,603,538,65,1
127,bc630298-b14e-431e-a1ef-b39ec6cc385c,36572649,818,605,213,8
127,bc630298-b14e-431e-a1ef-b39ec6cc385c,36572649,1087,844,243,9
127,bc630298-b14e-431e-a1ef-b39ec6cc385c,36572649,1467,1110,357,13
127,bc630298-b14e-431e-a1ef-b39ec6cc385c,36572649,2344,1472,872,14
127,bc630298-b14e-431e-a1ef-b39ec6cc385c,36572649,3272,2359,913,15
127,bc630298-b14e-431e-a1ef-b39ec6cc385c,36572649,4258,3326,932,16
127,bc630298-b14e-431e-a1ef-b39ec6cc385c,36572649,4838,4285,553,17
129,aa4ea3f6-0724-48b6-b7e4-2258e8032fbe,36573757,235,8,227,0
129,aa4ea3f6-0724-48b6-b7e4-2258e8032fbe,36573757,235,8,-227,0
129,aa4ea3f6-0724-48b6-b7e4-2258e8032fbe,36573757,583,244,339,1
129,aa4ea3f6-0724-48b6-b7e4-2258e8032fbe,36573757,583,244,-339,1
129,aa4ea3f6-0724-48b6-b7e4-2258e8032fbe,36573757,586,584,2,2
129,aa4ea3f6-0724-48b6-b7e4-2258e8032fbe,36573757,586,584,-2,2
129,aa4ea3f6-0724-48b6-b7e4-2258e8032fbe,36573757,1143,609,-534,15
129,aa4ea3f6-0724-48b6-b7e4-2258e8032fbe,36573757,1143,609,534,15
129,aa4ea3f6-0724-48b6-b7e4-2258e8032fbe,36573757,1644,1161,-483,16
129,aa4ea3f6-0724-48b6-b7e4-2258e8032fbe,36573757,1644,1161,483,16
129,aa4ea3f6-0724-48b6-b7e4-2258e8032fbe,36573757,1645,1645,0,17
124,801d5586-3760-4e4e-a861-e3e7d19ceaf7,36575947,181,3,178,0
124,801d5586-3760-4e4e-a861-e3e7d19ceaf7,36575947,309,188,121,1
124,801d5586-3760-4e4e-a861-e3e7d19ceaf7,36575947,459,316,143,3
124,801d5586-3760-4e4e-a861-e3e7d19ceaf7,36575947,624,463,161,4
124,801d5586-3760-4e4e-a861-e3e7d19ceaf7,36575947,748,628,120,5
124,801d5586-3760-4e4e-a861-e3e7d19ceaf7,36575947,1023,759,264,19
124,801d5586-3760-4e4e-a861-e3e7d19ceaf7,36575947,1344,1030,314,20
124,801d5586-3760-4e4e-a861-e3e7d19ceaf7,36575947,1522,1361,161,21
124,801d5586-3760-4e4e-a861-e3e7d19ceaf7,36575947,1580,1527,53,28
124,801d5586-3760-4e4e-a861-e3e7d19ceaf7,36575947,1767,1601,166,29
128,f600d2ea-2e65-41c1-9e8d-2521dc66100c,36584812,7464,119,7345,0
126,1d9adefa-660e-4ef1-ba52-35804f55c520,36590824,24,2,22,0
126,1d9adefa-660e-4ef1-ba52-35804f55c520,36590824,32,26,6,1
126,1d9adefa-660e-4ef1-ba52-35804f55c520,36590824,47,33,14,2
126,1d9adefa-660e-4ef1-ba52-35804f55c520,36590824,45,14,-31,3
126,1d9adefa-660e-4ef1-ba52-35804f55c520,36590824,808,53,755,4
126,1d9adefa-660e-4ef1-ba52-35804f55c520,36590824,2758,810,1948,5
128,2e687d20-677c-47dd-8914-91dcf7ec9562,36524213,1089,27,1062,0
128,2e687d20-677c-47dd-8914-91dcf7ec9562,36524213,1934,959,975,1
128,2e687d20-677c-47dd-8914-91dcf7ec9562,36524213,2887,1967,920,5
128,2e687d20-677c-47dd-8914-91dcf7ec9562,36524213,3948,2903,1045,6
128,2e687d20-677c-47dd-8914-91dcf7ec9562,36524213,4913,3999,914,7
128,2e687d20-677c-47dd-8914-91dcf7ec9562,36524213,6049,4934,1115,15
128,2e687d20-677c-47dd-8914-91dcf7ec9562,36524213,7023,6107,916,17
128,2e687d20-677c-47dd-8914-91dcf7ec9562,36590228,916,8,908,0
128,2e687d20-677c-47dd-8914-91dcf7ec9562,36590228,914,851,-63,1
128,2e687d20-677c-47dd-8914-91dcf7ec9562,36590228,877,783,-94,2
128,2e687d20-677c-47dd-8914-91dcf7ec9562,36590228,885,833,52,3
128,2e687d20-677c-47dd-8914-91dcf7ec9562,36590228,916,890,26,4
128,2e687d20-677c-47dd-8914-91dcf7ec9562,36590228,916,900,-16,5
128,2e687d20-677c-47dd-8914-91dcf7ec9562,36590228,916,905,11,6
128,2e687d20-677c-47dd-8914-91dcf7ec9562,36590228,915,702,-213,11
128,2e687d20-677c-47dd-8914-91dcf7ec9562,36590228,916,0,-916,12
126,1d9adefa-660e-4ef1-ba52-35804f55c520,36524213,711,9,702,0
126,1d9adefa-660e-4ef1-ba52-35804f55c520,36524213,1396,718,678,2
126,1d9adefa-660e-4ef1-ba52-35804f55c520,36524213,1434,1399,35,3
126,1d9adefa-660e-4ef1-ba52-35804f55c520,36524213,2254,1433,821,4
126,1d9adefa-660e-4ef1-ba52-35804f55c520,36524213,2694,2263,431,5
126,1d9adefa-660e-4ef1-ba52-35804f55c520,36524213,3273,2731,542,6
126,1d9adefa-660e-4ef1-ba52-35804f55c520,36524213,4400,3274,1126,7
126,1d9adefa-660e-4ef1-ba52-35804f55c520,36524213,5028,4417,611,8
126,1d9adefa-660e-4ef1-ba52-35804f55c520,36524213,8798,5070,3728,9
126,1d9adefa-660e-4ef1-ba52-35804f55c520,36524213,10616,8902,1714,10
126,1d9adefa-660e-4ef1-ba52-35804f55c520,36524213,10714,10714,0,11
126,1d9adefa-660e-4ef1-ba52-35804f55c520,36524213,10701,0,-10701,12
126,1d9adefa-660e-4ef1-ba52-35804f55c520,36524213,28,9,19,14
126,1d9adefa-660e-4ef1-ba52-35804f55c520,36524213,84,29,55,15
126,1d9adefa-660e-4ef1-ba52-35804f55c520,36524213,669,87,582,16
126,1d9adefa-660e-4ef1-ba52-35804f55c520,36524213,7024,684,6340,17
126,1d9adefa-660e-4ef1-ba52-35804f55c520,36524213,8190,7100,1090,18
128,2e687d20-677c-47dd-8914-91dcf7ec9562,36580159,872,13,859,0
128,2e687d20-677c-47dd-8914-91dcf7ec9562,36580159,2251,829,1422,1
128,2e687d20-677c-47dd-8914-91dcf7ec9562,36580159,2764,2170,594,3
128,2e687d20-677c-47dd-8914-91dcf7ec9562,36580159,3083,2797,-286,4
128,2e687d20-677c-47dd-8914-91dcf7ec9562,36580159,2648,1933,-715,5
128,2e687d20-677c-47dd-8914-91dcf7ec9562,36580159,2919,1964,955,9
128,2e687d20-677c-47dd-8914-91dcf7ec9562,36580159,3953,2912,1041,10
128,2e687d20-677c-47dd-8914-91dcf7ec9562,36580159,5734,3982,1752,11
128,2e687d20-677c-47dd-8914-91dcf7ec9562,36580159,6918,5834,1084,12
128,2e687d20-677c-47dd-8914-91dcf7ec9562,36580159,9791,6993,2798,13
128,2e687d20-677c-47dd-8914-91dcf7ec9562,36580159,10960,9908,1052,14
126,1d9adefa-660e-4ef1-ba52-35804f55c520,36524212,2472,192,2280,1
126,1d9adefa-660e-4ef1-ba52-35804f55c520,36524212,7850,2528,5322,2
126,1d9adefa-660e-4ef1-ba52-35804f55c520,36524212,11220,8058,3162,3
126,1d9adefa-660e-4ef1-ba52-35804f55c520,36524212,11203,0,-11203,4
126,1d9adefa-660e-4ef1-ba52-35804f55c520,36524212,2582,38,2544,6
126,1d9adefa-660e-4ef1-ba52-35804f55c520,36524212,7661,2701,4960,7
126,1d9adefa-660e-4ef1-ba52-35804f55c520,36524212,10228,7812,2416,8
126,1d9adefa-660e-4ef1-ba52-35804f55c520,36524212,11220,10263,957,9
128,2e687d20-677c-47dd-8914-91dcf7ec9562,36590813,65,65,0,0
128,2e687d20-677c-47dd-8914-91dcf7ec9562,36590813,2180,171,2009,1
128,2e687d20-677c-47dd-8914-91dcf7ec9562,36590813,2178,0,-2178,2
128,2e687d20-677c-47dd-8914-91dcf7ec9562,36590813,2180,27,2153,9
128,2e687d20-677c-47dd-8914-91dcf7ec9562,36590813,2163,0,-2163,10
128,2e687d20-677c-47dd-8914-91dcf7ec9562,36590813,947,39,908,13
133,994c6021-ae57-4531-ace8-4c2ee91bf920,36524212,27,27,0,0
133,994c6021-ae57-4531-ace8-4c2ee91bf920,36524212,1122,64,1058,1
133,994c6021-ae57-4531-ace8-4c2ee91bf920,36524212,1130,1124,6,2
133,994c6021-ae57-4531-ace8-4c2ee91bf920,36524212,1086,403,-683,3
133,994c6021-ae57-4531-ace8-4c2ee91bf920,36524212,402,0,-402,4
133,994c6021-ae57-4531-ace8-4c2ee91bf920,36524212,99,99,0,7
133,994c6021-ae57-4531-ace8-4c2ee91bf920,36524212,11128,322,10806,8
133,994c6021-ae57-4531-ace8-4c2ee91bf920,36524212,11220,11218,2,9
133,994c6021-ae57-4531-ace8-4c2ee91bf920,36524212,11219,10542,-677,10
133,994c6021-ae57-4531-ace8-4c2ee91bf920,36524212,10527,9725,-802,11
133,994c6021-ae57-4531-ace8-4c2ee91bf920,36524212,9674,8308,-1366,12
133,994c6021-ae57-4531-ace8-4c2ee91bf920,36524212,8307,8305,-2,13
133,994c6021-ae57-4531-ace8-4c2ee91bf920,36579430,0,0,0,0
133,994c6021-ae57-4531-ace8-4c2ee91bf920,36579430,595,36,559,2
133,994c6021-ae57-4531-ace8-4c2ee91bf920,36579430,1036,611,425,3
133,994c6021-ae57-4531-ace8-4c2ee91bf920,36579430,1562,1064,498,5
133,994c6021-ae57-4531-ace8-4c2ee91bf920,36579430,2031,9,2022,6
133,994c6021-ae57-4531-ace8-4c2ee91bf920,36579430,2618,2049,569,20
133,994c6021-ae57-4531-ace8-4c2ee91bf920,36579430,3223,2632,591,21
133,994c6021-ae57-4531-ace8-4c2ee91bf920,36579430,3770,3240,530,22
133,994c6021-ae57-4531-ace8-4c2ee91bf920,36579430,4257,3793,464,31
133,994c6021-ae57-4531-ace8-4c2ee91bf920,36579430,4770,4265,505,33
133,994c6021-ae57-4531-ace8-4c2ee91bf920,36579430,5158,4778,380,34
133,994c6021-ae57-4531-ace8-4c2ee91bf920,36579430,5282,5177,105,35
133,994c6021-ae57-4531-ace8-4c2ee91bf920,36579430,5258,4926,-332,46
133,994c6021-ae57-4531-ace8-4c2ee91bf920,36579430,4894,4176,-718,47
133,994c6021-ae57-4531-ace8-4c2ee91bf920,36579430,4162,3679,-483,48
133,994c6021-ae57-4531-ace8-4c2ee91bf920,36579430,3665,3227,-438,49
133,994c6021-ae57-4531-ace8-4c2ee91bf920,36579430,3722,3241,481,57
133,994c6021-ae57-4531-ace8-4c2ee91bf920,36579430,4355,3737,618,58
133,994c6021-ae57-4531-ace8-4c2ee91bf920,36579430,4880,4360,520,59
133,994c6021-ae57-4531-ace8-4c2ee91bf920,36579430,5282,4895,387,69
130,1c23085d-0e52-494d-b85c-3fa8a10daabd,36594086,489,7,482,0
130,1c23085d-0e52-494d-b85c-3fa8a10daabd,36594086,746,497,249,1
130,1c23085d-0e52-494d-b85c-3fa8a10daabd,36594086,807,749,58,2
8,d55522e0-32c2-48d9-afa5-5667b32578ce,36582567,156,10,146,0
8,d55522e0-32c2-48d9-afa5-5667b32578ce,36582567,250,158,92,1
8,d55522e0-32c2-48d9-afa5-5667b32578ce,36582567,304,255,49,2
8,d55522e0-32c2-48d9-afa5-5667b32578ce,36582567,257,0,-257,3
8,d55522e0-32c2-48d9-afa5-5667b32578ce,36582567,126,8,118,23
8,d55522e0-32c2-48d9-afa5-5667b32578ce,36582567,435,132,303,24
8,d55522e0-32c2-48d9-afa5-5667b32578ce,36582567,715,447,268,25
8,d55522e0-32c2-48d9-afa5-5667b32578ce,36582567,1006,717,289,26
8,d55522e0-32c2-48d9-afa5-5667b32578ce,36582567,1184,1007,177,27
8,d55522e0-32c2-48d9-afa5-5667b32578ce,36582567,1331,1201,130,28
8,d55522e0-32c2-48d9-afa5-5667b32578ce,36582567,1483,1345,138,29
8,d55522e0-32c2-48d9-afa5-5667b32578ce,36582567,1677,1491,186,30
8,d55522e0-32c2-48d9-afa5-5667b32578ce,36582567,1759,1684,75,31
8,d55522e0-32c2-48d9-afa5-5667b32578ce,36582567,1850,1770,80,32
8,d55522e0-32c2-48d9-afa5-5667b32578ce,36582567,1930,1854,76,33
8,d55522e0-32c2-48d9-afa5-5667b32578ce,36582567,1987,1937,50,34
8,d55522e0-32c2-48d9-afa5-5667b32578ce,36582567,2588,1999,589,42
8,d55522e0-32c2-48d9-afa5-5667b32578ce,36582567,2909,2591,318,43
8,d55522e0-32c2-48d9-afa5-5667b32578ce,36582567,3599,2984,615,44
8,d55522e0-32c2-48d9-afa5-5667b32578ce,36582567,4072,3600,472,45
8,d55522e0-32c2-48d9-afa5-5667b32578ce,36582567,5284,4074,1210,46
8,d55522e0-32c2-48d9-afa5-5667b32578ce,36582567,5564,5309,255,47
8,8edec827-9700-4fe7-985a-b0a4577086c8,36524210,22,1,21,0
8,8edec827-9700-4fe7-985a-b0a4577086c8,36524210,20,0,-20,1
8,8edec827-9700-4fe7-985a-b0a4577086c8,36524210,21,0,-21,2
8,8edec827-9700-4fe7-985a-b0a4577086c8,36524210,15,6,9,5
8,8edec827-9700-4fe7-985a-b0a4577086c8,36524210,123,20,103,6
8,8edec827-9700-4fe7-985a-b0a4577086c8,36524210,324,127,197,7
8,8edec827-9700-4fe7-985a-b0a4577086c8,36524210,577,329,248,8
8,8edec827-9700-4fe7-985a-b0a4577086c8,36524210,769,589,180,9
8,8edec827-9700-4fe7-985a-b0a4577086c8,36524210,856,770,86,10
8,8edec827-9700-4fe7-985a-b0a4577086c8,36524210,948,864,84,17
8,8edec827-9700-4fe7-985a-b0a4577086c8,36524210,1389,989,400,34
8,8edec827-9700-4fe7-985a-b0a4577086c8,36524210,1624,1393,231,35
8,8edec827-9700-4fe7-985a-b0a4577086c8,36524210,1816,1637,179,39
126,ad874a06-052e-4706-855b-3eda4ceda380,36586021,164,22,142,0
126,ad874a06-052e-4706-855b-3eda4ceda380,36586021,406,194,212,1
126,ad874a06-052e-4706-855b-3eda4ceda380,36586021,452,411,41,6
126,ad874a06-052e-4706-855b-3eda4ceda380,36586021,586,455,131,7
126,ad874a06-052e-4706-855b-3eda4ceda380,36586021,587,587,0,8
126,ad874a06-052e-4706-855b-3eda4ceda380,36586021,841,607,234,14
126,ad874a06-052e-4706-855b-3eda4ceda380,36586021,850,845,5,15
126,ad874a06-052e-4706-855b-3eda4ceda380,36586021,1250,855,395,35
126,ad874a06-052e-4706-855b-3eda4ceda380,36586021,1263,1251,12,39
126,ad874a06-052e-4706-855b-3eda4ceda380,36586021,1353,1265,88,40
126,ad874a06-052e-4706-855b-3eda4ceda380,36586021,1474,1359,115,41
126,ad874a06-052e-4706-855b-3eda4ceda380,36586021,1729,1476,253,50
126,ad874a06-052e-4706-855b-3eda4ceda380,36586021,2204,1751,453,51
126,ad874a06-052e-4706-855b-3eda4ceda380,36586021,2521,2260,261,181
126,ad874a06-052e-4706-855b-3eda4ceda380,36586021,2601,2540,61,182
126,ad874a06-052e-4706-855b-3eda4ceda380,36586021,3157,2626,531,241
126,ad874a06-052e-4706-855b-3eda4ceda380,36579125,480,4,476,0
126,ad874a06-052e-4706-855b-3eda4ceda380,36579125,511,480,31,5
126,ad874a06-052e-4706-855b-3eda4ceda380,36579125,771,523,248,6
126,ad874a06-052e-4706-855b-3eda4ceda380,36579125,825,774,51,9
126,ad874a06-052e-4706-855b-3eda4ceda380,36579125,957,828,129,10
126,ad874a06-052e-4706-855b-3eda4ceda380,36579125,1511,971,540,20
126,ad874a06-052e-4706-855b-3eda4ceda380,36579125,1530,1518,12,21
126,ad874a06-052e-4706-855b-3eda4ceda380,36579125,1864,1550,314,33
126,ad874a06-052e-4706-855b-3eda4ceda380,36579125,1984,1870,114,50
126,ad874a06-052e-4706-855b-3eda4ceda380,36579125,2262,2047,215,58
126,ad874a06-052e-4706-855b-3eda4ceda380,36579125,2299,2269,30,59
126,ad874a06-052e-4706-855b-3eda4ceda380,36579125,2703,2307,396,62
126,ad874a06-052e-4706-855b-3eda4ceda380,36579125,2859,2704,155,72
126,ad874a06-052e-4706-855b-3eda4ceda380,36579125,2853,2748,-105,78
126,ad874a06-052e-4706-855b-3eda4ceda380,36579125,2746,2744,-2,79
126,ad874a06-052e-4706-855b-3eda4ceda380,36579125,2825,2750,75,89
126,ad874a06-052e-4706-855b-3eda4ceda380,36579125,3008,2826,182,90
126,ad874a06-052e-4706-855b-3eda4ceda380,36579125,3042,3011,31,91
126,ad874a06-052e-4706-855b-3eda4ceda380,36579125,3257,3048,209,93
126,ad874a06-052e-4706-855b-3eda4ceda380,36579125,3316,3260,56,94
126,ad874a06-052e-4706-855b-3eda4ceda380,36579125,3510,3323,187,98
127,c5e70f4c-d511-4e21-9ebb-c9d3c68d158e,36596070,508,11,497,0
127,c5e70f4c-d511-4e21-9ebb-c9d3c68d158e,36596070,604,520,84,1
127,c5e70f4c-d511-4e21-9ebb-c9d3c68d158e,36596070,715,605,110,2
127,c5e70f4c-d511-4e21-9ebb-c9d3c68d158e,36596070,881,720,161,3
127,c5e70f4c-d511-4e21-9ebb-c9d3c68d158e,36596070,914,682,-232,4
127,c5e70f4c-d511-4e21-9ebb-c9d3c68d158e,36596070,708,684,24,5
127,c5e70f4c-d511-4e21-9ebb-c9d3c68d158e,36596070,794,709,85,6
127,c5e70f4c-d511-4e21-9ebb-c9d3c68d158e,36596070,886,795,91,7
127,c5e70f4c-d511-4e21-9ebb-c9d3c68d158e,36596070,1112,893,219,8
127,c5e70f4c-d511-4e21-9ebb-c9d3c68d158e,36596070,1350,1117,233,16
127,c5e70f4c-d511-4e21-9ebb-c9d3c68d158e,36596070,1526,1357,169,17
127,c5e70f4c-d511-4e21-9ebb-c9d3c68d158e,36596070,1744,1536,208,18
127,c5e70f4c-d511-4e21-9ebb-c9d3c68d158e,36596070,1993,1752,241,19
8,8075680f-9be7-4982-a8df-07f3cb63d8ed,36594834,1866,50,1816,0
8,8075680f-9be7-4982-a8df-07f3cb63d8ed,36594834,1903,1867,36,1
24,ee518215-0c04-4b3d-9a94-dd5afd974d1e,36594705,245,1,244,0
24,ee518215-0c04-4b3d-9a94-dd5afd974d1e,36594705,655,249,406,1
24,ee518215-0c04-4b3d-9a94-dd5afd974d1e,36594705,675,656,19,2
24,ee518215-0c04-4b3d-9a94-dd5afd974d1e,36594705,912,711,201,3
24,ee518215-0c04-4b3d-9a94-dd5afd974d1e,36594705,2020,943,1077,4
124,a3ba2439-7ef5-4e24-a15f-7b8e007cdd8a,36598140,466,8,458,0
124,a3ba2439-7ef5-4e24-a15f-7b8e007cdd8a,36598140,1455,513,942,1
124,a3ba2439-7ef5-4e24-a15f-7b8e007cdd8a,36598140,1871,1457,414,2
124,a3ba2439-7ef5-4e24-a15f-7b8e007cdd8a,36598140,3093,1880,1213,3
124,a3ba2439-7ef5-4e24-a15f-7b8e007cdd8a,36598140,3673,3142,531,4
124,a3ba2439-7ef5-4e24-a15f-7b8e007cdd8a,36598140,5663,3272,2391,5
124,a3ba2439-7ef5-4e24-a15f-7b8e007cdd8a,36598140,5659,3534,-2125,6
124,a3ba2439-7ef5-4e24-a15f-7b8e007cdd8a,36598140,3507,2963,-544,7
124,a3ba2439-7ef5-4e24-a15f-7b8e007cdd8a,36598140,2952,1874,-1078,8
124,a3ba2439-7ef5-4e24-a15f-7b8e007cdd8a,36598140,1865,1578,-287,9
124,a3ba2439-7ef5-4e24-a15f-7b8e007cdd8a,36598140,1573,227,-1346,10
124,a3ba2439-7ef5-4e24-a15f-7b8e007cdd8a,36598140,219,0,-219,11
125,0cc521c3-db3d-410e-9005-4ce578242622,36602509,108,5,103,0
125,0cc521c3-db3d-410e-9005-4ce578242622,36602509,141,110,31,1
125,0cc521c3-db3d-410e-9005-4ce578242622,36602509,140,0,-140,2
125,0cc521c3-db3d-410e-9005-4ce578242622,36602509,17,3,14,4
125,0cc521c3-db3d-410e-9005-4ce578242622,36602509,321,19,302,5
125,0cc521c3-db3d-410e-9005-4ce578242622,36602509,508,330,178,6
125,0cc521c3-db3d-410e-9005-4ce578242622,36592782,298,5,293,0
125,0cc521c3-db3d-410e-9005-4ce578242622,36592782,651,307,344,1
125,0cc521c3-db3d-410e-9005-4ce578242622,36592782,696,655,41,6
125,0cc521c3-db3d-410e-9005-4ce578242622,36592782,797,711,86,7
125,0cc521c3-db3d-410e-9005-4ce578242622,36592782,1047,798,249,12
125,0cc521c3-db3d-410e-9005-4ce578242622,36592782,1102,1051,51,13
125,0cc521c3-db3d-410e-9005-4ce578242622,36592782,1196,1104,92,32
125,0cc521c3-db3d-410e-9005-4ce578242622,36592782,1436,1200,236,33
125,0cc521c3-db3d-410e-9005-4ce578242622,36592782,1438,1438,0,34
125,0cc521c3-db3d-410e-9005-4ce578242622,36592782,1542,1439,103,43
125,0cc521c3-db3d-410e-9005-4ce578242622,36592782,1591,1548,43,44
125,0cc521c3-db3d-410e-9005-4ce578242622,36599316,203,4,199,0
125,0cc521c3-db3d-410e-9005-4ce578242622,36599316,217,206,11,1
125,b30cfd40-15dc-428f-8313-7e7b9eda7732,36612368,787,14,773,0
125,b30cfd40-15dc-428f-8313-7e7b9eda7732,36612368,1225,806,419,1
125,b30cfd40-15dc-428f-8313-7e7b9eda7732,36612368,2020,1409,611,2
125,b30cfd40-15dc-428f-8313-7e7b9eda7732,36612368,2191,2026,165,5
125,b30cfd40-15dc-428f-8313-7e7b9eda7732,36612368,2402,2204,198,6
125,b30cfd40-15dc-428f-8313-7e7b9eda7732,36612368,3220,2673,547,11
125,b30cfd40-15dc-428f-8313-7e7b9eda7732,36612368,3671,3229,442,19
125,b30cfd40-15dc-428f-8313-7e7b9eda7732,36612368,3679,3672,7,20
125,b30cfd40-15dc-428f-8313-7e7b9eda7732,36612368,4241,3684,557,28
125,b30cfd40-15dc-428f-8313-7e7b9eda7732,36612368,4246,4246,0,39
125,b30cfd40-15dc-428f-8313-7e7b9eda7732,36612368,5102,4292,810,40
125,b30cfd40-15dc-428f-8313-7e7b9eda7732,36612368,5613,4990,623,41
125,b30cfd40-15dc-428f-8313-7e7b9eda7732,36612368,6594,5631,963,42
125,b30cfd40-15dc-428f-8313-7e7b9eda7732,36612368,6848,6618,230,43
125,b30cfd40-15dc-428f-8313-7e7b9eda7732,36612368,6938,6893,45,47
125,b30cfd40-15dc-428f-8313-7e7b9eda7732,36612368,7277,6974,303,48
125,b30cfd40-15dc-428f-8313-7e7b9eda7732,36612368,7567,7279,288,49
125,b30cfd40-15dc-428f-8313-7e7b9eda7732,36612368,8842,7585,1257,54
125,b30cfd40-15dc-428f-8313-7e7b9eda7732,36612368,9439,8886,553,55
125,f550babb-7286-496b-8fa3-3f082357ae72,36621030,536,18,518,0
125,f550babb-7286-496b-8fa3-3f082357ae72,36621030,422,319,-103,1
125,f550babb-7286-496b-8fa3-3f082357ae72,36621030,522,379,143,2
125,f550babb-7286-496b-8fa3-3f082357ae72,36621030,632,542,90,4
125,f550babb-7286-496b-8fa3-3f082357ae72,36621030,1861,700,1161,5
125,f550babb-7286-496b-8fa3-3f082357ae72,36621030,1862,1862,0,6
125,f550babb-7286-496b-8fa3-3f082357ae72,36621030,2665,1865,800,11
125,f550babb-7286-496b-8fa3-3f082357ae72,36621030,3292,2668,624,26
125,f550babb-7286-496b-8fa3-3f082357ae72,36621030,3717,3329,388,27
133,a86020c1-5d8a-43ef-aa11-402a1998a73f,36615028,184,8,176,0
133,a86020c1-5d8a-43ef-aa11-402a1998a73f,36615028,103,35,68,1
133,a86020c1-5d8a-43ef-aa11-402a1998a73f,36615028,761,128,633,13
133,a86020c1-5d8a-43ef-aa11-402a1998a73f,36615028,1303,775,528,14
133,a86020c1-5d8a-43ef-aa11-402a1998a73f,36615028,3626,1318,2308,15
133,a86020c1-5d8a-43ef-aa11-402a1998a73f,36615028,3809,3642,167,16
133,5a7532ef-59e6-4290-b067-5f96e61b07f1,36608269,135,6,129,0
133,5a7532ef-59e6-4290-b067-5f96e61b07f1,36608269,420,34,-386,1
133,5a7532ef-59e6-4290-b067-5f96e61b07f1,36608269,47,0,47,2
133,5a7532ef-59e6-4290-b067-5f96e61b07f1,36608269,246,55,191,3
133,5a7532ef-59e6-4290-b067-5f96e61b07f1,36608269,407,270,137,4
133,5a7532ef-59e6-4290-b067-5f96e61b07f1,36608269,644,416,228,9
133,5a7532ef-59e6-4290-b067-5f96e61b07f1,36608269,949,648,301,17
133,5a7532ef-59e6-4290-b067-5f96e61b07f1,36608269,1074,967,107,23
133,5a7532ef-59e6-4290-b067-5f96e61b07f1,36608269,1195,1094,101,24
133,5a7532ef-59e6-4290-b067-5f96e61b07f1,36608269,1448,1198,250,28
133,5a7532ef-59e6-4290-b067-5f96e61b07f1,36608269,1728,1471,257,33
133,5a7532ef-59e6-4290-b067-5f96e61b07f1,36574299,198,3,195,0
133,5a7532ef-59e6-4290-b067-5f96e61b07f1,36574299,305,209,96,1
133,5a7532ef-59e6-4290-b067-5f96e61b07f1,36574299,640,314,326,5
133,5a7532ef-59e6-4290-b067-5f96e61b07f1,36574299,801,641,160,8
133,5a7532ef-59e6-4290-b067-5f96e61b07f1,36574299,961,820,141,9
133,5a7532ef-59e6-4290-b067-5f96e61b07f1,36574299,1235,971,264,12
133,5a7532ef-59e6-4290-b067-5f96e61b07f1,36574299,1255,1238,17,13
133,5a7532ef-59e6-4290-b067-5f96e61b07f1,36574299,1532,1265,267,24
8,ce86df48-ad19-478b-a037-d390d52e6ed7,36647032,131,6,125,0
8,ce86df48-ad19-478b-a037-d390d52e6ed7,36647032,305,134,171,1
8,ce86df48-ad19-478b-a037-d390d52e6ed7,36647032,483,321,162,2
8,ce86df48-ad19-478b-a037-d390d52e6ed7,36647032,642,492,150,3
8,ce86df48-ad19-478b-a037-d390d52e6ed7,36647032,832,644,188,4
8,ce86df48-ad19-478b-a037-d390d52e6ed7,36647032,841,836,5,5
8,ce86df48-ad19-478b-a037-d390d52e6ed7,36647032,910,851,59,9
8,ce86df48-ad19-478b-a037-d390d52e6ed7,36647032,967,920,47,10
8,ce86df48-ad19-478b-a037-d390d52e6ed7,36647032,1029,977,52,11
8,ce86df48-ad19-478b-a037-d390d52e6ed7,36647032,1086,1035,51,12
8,ce86df48-ad19-478b-a037-d390d52e6ed7,36647032,1141,1089,52,17
8,ce86df48-ad19-478b-a037-d390d52e6ed7,36647032,1186,1147,39,18
8,ce86df48-ad19-478b-a037-d390d52e6ed7,36647032,1273,1192,81,19
8,ce86df48-ad19-478b-a037-d390d52e6ed7,36647032,1417,1289,128,20
8,ce86df48-ad19-478b-a037-d390d52e6ed7,36647032,1569,1425,144,21
8,ce86df48-ad19-478b-a037-d390d52e6ed7,36647032,1658,1573,85,22
8,ce86df48-ad19-478b-a037-d390d52e6ed7,36637591,37,2,35,0
8,ce86df48-ad19-478b-a037-d390d52e6ed7,36637591,219,49,170,1
8,ce86df48-ad19-478b-a037-d390d52e6ed7,36637591,281,224,57,2
8,ce86df48-ad19-478b-a037-d390d52e6ed7,36637591,414,282,132,3
8,ce86df48-ad19-478b-a037-d390d52e6ed7,36637591,499,420,79,4
8,ce86df48-ad19-478b-a037-d390d52e6ed7,36637591,569,507,62,5
8,ce86df48-ad19-478b-a037-d390d52e6ed7,36637591,640,576,64,6
8,ce86df48-ad19-478b-a037-d390d52e6ed7,36637591,669,641,28,7
8,ce86df48-ad19-478b-a037-d390d52e6ed7,36637591,754,670,84,13
8,ce86df48-ad19-478b-a037-d390d52e6ed7,36637591,804,759,45,14
8,ce86df48-ad19-478b-a037-d390d52e6ed7,36637591,860,812,48,15
8,ce86df48-ad19-478b-a037-d390d52e6ed7,36637591,983,865,118,40
8,ce86df48-ad19-478b-a037-d390d52e6ed7,36637591,1025,985,40,41
8,ce86df48-ad19-478b-a037-d390d52e6ed7,36637591,1119,1033,86,42
8,ce86df48-ad19-478b-a037-d390d52e6ed7,36637591,1204,1126,78,43
8,ce86df48-ad19-478b-a037-d390d52e6ed7,36637591,1311,1207,104,45
8,fe5b5a01-3418-4a75-bb52-6178ab712af4,36642667,159,14,145,0
8,fe5b5a01-3418-4a75-bb52-6178ab712af4,36642667,517,181,336,1
8,fe5b5a01-3418-4a75-bb52-6178ab712af4,36642667,1390,557,833,2
8,fe5b5a01-3418-4a75-bb52-6178ab712af4,36642667,2515,1443,1072,3
8,fe5b5a01-3418-4a75-bb52-6178ab712af4,36642667,2913,2535,378,4
8,fe5b5a01-3418-4a75-bb52-6178ab712af4,36642667,3424,2943,481,5
8,fe5b5a01-3418-4a75-bb52-6178ab712af4,36642667,4159,3457,702,6
8,fe5b5a01-3418-4a75-bb52-6178ab712af4,36642667,4308,4203,105,7
8,fe5b5a01-3418-4a75-bb52-6178ab712af4,36642667,4301,4097,-204,8
8,fe5b5a01-3418-4a75-bb52-6178ab712af4,36642667,4075,1272,-2803,9
8,fe5b5a01-3418-4a75-bb52-6178ab712af4,36642667,1212,354,-858,10
8,c6b0ebc3-ccd4-42df-ae56-23e7726f853e,36626454,474,9,465,0
8,c6b0ebc3-ccd4-42df-ae56-23e7726f853e,36626454,586,481,105,1
8,c6b0ebc3-ccd4-42df-ae56-23e7726f853e,36626454,738,597,141,2
8,c6b0ebc3-ccd4-42df-ae56-23e7726f853e,36626454,834,741,93,6
8,c6b0ebc3-ccd4-42df-ae56-23e7726f853e,36626454,915,844,71,7
8,c6b0ebc3-ccd4-42df-ae56-23e7726f853e,36626454,908,871,-37,8
8,c6b0ebc3-ccd4-42df-ae56-23e7726f853e,36626454,859,782,-77,9
8,c6b0ebc3-ccd4-42df-ae56-23e7726f853e,36626454,1067,824,243,10
8,c6b0ebc3-ccd4-42df-ae56-23e7726f853e,36626454,1696,1080,616,11
8,4936cbd5-55e6-4d3e-8735-5e3cb1886bac,36644934,3804,14,3790,0
8,4936cbd5-55e6-4d3e-8735-5e3cb1886bac,36644934,4686,3921,765,1
8,4936cbd5-55e6-4d3e-8735-5e3cb1886bac,36644934,4592,0,-4592,2
8,4936cbd5-55e6-4d3e-8735-5e3cb1886bac,36644934,1081,46,1035,3
8,4936cbd5-55e6-4d3e-8735-5e3cb1886bac,36644934,1463,1090,373,4
8,4936cbd5-55e6-4d3e-8735-5e3cb1886bac,36644934,1841,1477,364,5
8,4936cbd5-55e6-4d3e-8735-5e3cb1886bac,36644934,2218,1877,341,6
8,a98b878b-2fb2-4f23-b314-57d0fadf6d57,36646251,476,49,427,0
8,a98b878b-2fb2-4f23-b314-57d0fadf6d57,36646251,1134,480,654,1
8,a98b878b-2fb2-4f23-b314-57d0fadf6d57,36646251,1089,0,-1089,2
8,a98b878b-2fb2-4f23-b314-57d0fadf6d57,36646251,1134,11,1123,3
8,a98b878b-2fb2-4f23-b314-57d0fadf6d57,36646251,1134,0,1134,4
8,a98b878b-2fb2-4f23-b314-57d0fadf6d57,36646251,1134,0,-1134,4
8,a98b878b-2fb2-4f23-b314-57d0fadf6d57,36646251,1134,0,1134,5
125,0eeea390-08a6-4f1b-bfd5-0f0e63a984de,36640464,712,23,689,0
125,0eeea390-08a6-4f1b-bfd5-0f0e63a984de,36640464,967,751,216,1
125,0eeea390-08a6-4f1b-bfd5-0f0e63a984de,36640464,1608,978,630,16
125,0eeea390-08a6-4f1b-bfd5-0f0e63a984de,36640464,1608,1607,1,18
125,0eeea390-08a6-4f1b-bfd5-0f0e63a984de,36640464,1608,1607,-1,18
125,0eeea390-08a6-4f1b-bfd5-0f0e63a984de,36640464,1608,1442,-166,19
125,0eeea390-08a6-4f1b-bfd5-0f0e63a984de,36640464,1608,1444,164,20
125,0eeea390-08a6-4f1b-bfd5-0f0e63a984de,36640464,1599,1272,-327,51
125,0eeea390-08a6-4f1b-bfd5-0f0e63a984de,36640464,1227,108,-1119,52
125,0eeea390-08a6-4f1b-bfd5-0f0e63a984de,36638178,1042,20,1022,0
125,0eeea390-08a6-4f1b-bfd5-0f0e63a984de,36638178,1079,1052,27,1
125,0eeea390-08a6-4f1b-bfd5-0f0e63a984de,36638178,1101,1101,0,8
125,0eeea390-08a6-4f1b-bfd5-0f0e63a984de,36638178,1621,1126,495,9
125,0eeea390-08a6-4f1b-bfd5-0f0e63a984de,36638178,1624,1623,1,10
125,0eeea390-08a6-4f1b-bfd5-0f0e63a984de,36638178,3666,1669,1997,21
125,0eeea390-08a6-4f1b-bfd5-0f0e63a984de,36638178,3912,3745,167,22
125,0eeea390-08a6-4f1b-bfd5-0f0e63a984de,36638178,3887,2966,-921,24
125,0eeea390-08a6-4f1b-bfd5-0f0e63a984de,36638178,3450,3025,425,26
125,0eeea390-08a6-4f1b-bfd5-0f0e63a984de,36638178,3534,3453,81,27
125,37c6d71b-7c08-4a97-9995-695f9f9b928e,36659894,255,19,236,0
125,37c6d71b-7c08-4a97-9995-695f9f9b928e,36659894,828,261,567,1
125,37c6d71b-7c08-4a97-9995-695f9f9b928e,36659894,828,41,787,22
250,bc43f889-0333-48d8-b17e-3918ca1e1ef8,36659900,534,11,523,0
250,bc43f889-0333-48d8-b17e-3918ca1e1ef8,36659900,540,537,3,1
250,bc43f889-0333-48d8-b17e-3918ca1e1ef8,36659900,1188,559,629,3
250,bc43f889-0333-48d8-b17e-3918ca1e1ef8,36659900,1532,1200,332,5
250,bc43f889-0333-48d8-b17e-3918ca1e1ef8,36659900,1531,479,-1052,6
250,bc43f889-0333-48d8-b17e-3918ca1e1ef8,36659900,800,508,292,7
250,bc43f889-0333-48d8-b17e-3918ca1e1ef8,36659900,809,801,8,8
250,bc43f889-0333-48d8-b17e-3918ca1e1ef8,36659900,1544,873,671,15
250,bc43f889-0333-48d8-b17e-3918ca1e1ef8,36659900,2935,1644,1291,16
250,bc43f889-0333-48d8-b17e-3918ca1e1ef8,36645822,421,19,402,0
250,bc43f889-0333-48d8-b17e-3918ca1e1ef8,36645822,410,297,-113,5
250,bc43f889-0333-48d8-b17e-3918ca1e1ef8,36645822,259,0,-259,6
250,bc43f889-0333-48d8-b17e-3918ca1e1ef8,36645822,1509,1,1508,7
250,bc43f889-0333-48d8-b17e-3918ca1e1ef8,36645822,1955,1555,400,9
250,bc43f889-0333-48d8-b17e-3918ca1e1ef8,36645822,2834,1987,847,10
250,bc43f889-0333-48d8-b17e-3918ca1e1ef8,36645822,2925,2846,79,11
250,bc43f889-0333-48d8-b17e-3918ca1e1ef8,36645822,3419,2960,459,15
250,bc43f889-0333-48d8-b17e-3918ca1e1ef8,36645822,3933,3473,460,16
250,bc43f889-0333-48d8-b17e-3918ca1e1ef8,36645822,4882,3948,934,18
250,bc43f889-0333-48d8-b17e-3918ca1e1ef8,36645822,5088,4904,184,19
250,bc43f889-0333-48d8-b17e-3918ca1e1ef8,36645822,5646,5099,547,24
250,bc43f889-0333-48d8-b17e-3918ca1e1ef8,36662636,161,11,150,0
250,bc43f889-0333-48d8-b17e-3918ca1e1ef8,36662636,410,191,219,1
250,bc43f889-0333-48d8-b17e-3918ca1e1ef8,36662636,848,415,433,2
250,bc43f889-0333-48d8-b17e-3918ca1e1ef8,36662636,1201,851,350,4
250,bc43f889-0333-48d8-b17e-3918ca1e1ef8,36662636,1296,1207,89,6
250,bc43f889-0333-48d8-b17e-3918ca1e1ef8,36662636,1693,1335,358,7
250,bc43f889-0333-48d8-b17e-3918ca1e1ef8,36662636,2696,1726,970,9
250,bc43f889-0333-48d8-b17e-3918ca1e1ef8,36662636,3516,2721,795,10
250,bc43f889-0333-48d8-b17e-3918ca1e1ef8,36662636,3677,3543,134,11
250,bc43f889-0333-48d8-b17e-3918ca1e1ef8,36662636,3544,0,-3544,12
250,bc43f889-0333-48d8-b17e-3918ca1e1ef8,36662636,1552,113,1439,14
250,bc43f889-0333-48d8-b17e-3918ca1e1ef8,36662636,3561,1742,1819,15
250,bc43f889-0333-48d8-b17e-3918ca1e1ef8,36662636,4029,3582,447,16
250,bc43f889-0333-48d8-b17e-3918ca1e1ef8,36662636,3916,1782,-2134,17
250,bc43f889-0333-48d8-b17e-3918ca1e1ef8,36662636,1761,1609,-152,18
250,bc43f889-0333-48d8-b17e-3918ca1e1ef8,36662636,1533,753,-780,19
251,a5c9e301-b855-4584-9328-27c0040194b5,36663181,190,5,185,0
251,a5c9e301-b855-4584-9328-27c0040194b5,36663181,540,196,344,1
251,a5c9e301-b855-4584-9328-27c0040194b5,36663181,833,551,282,2
251,a5c9e301-b855-4584-9328-27c0040194b5,36663181,887,847,40,3
251,a5c9e301-b855-4584-9328-27c0040194b5,36663181,1035,893,142,8
251,a5c9e301-b855-4584-9328-27c0040194b5,36663181,2174,1060,1114,9
251,a5c9e301-b855-4584-9328-27c0040194b5,36663181,2183,2177,6,10
251,a5c9e301-b855-4584-9328-27c0040194b5,36663181,2683,2228,455,11
251,a5c9e301-b855-4584-9328-27c0040194b5,36663181,3933,2711,1222,12
251,a5c9e301-b855-4584-9328-27c0040194b5,36663181,4066,3949,117,13
251,a5c9e301-b855-4584-9328-27c0040194b5,36663181,3954,3427,-527,14
251,a5c9e301-b855-4584-9328-27c0040194b5,36663181,3605,3439,166,23
251,a5c9e301-b855-4584-9328-27c0040194b5,36663181,4972,3611,1361,24
126,51948097-a988-43db-820e-ed4b05e21f44,36663127,126,6,120,0
126,51948097-a988-43db-820e-ed4b05e21f44,36663127,483,185,298,1
126,51948097-a988-43db-820e-ed4b05e21f44,36663127,963,491,472,23
126,51948097-a988-43db-820e-ed4b05e21f44,36663127,1104,966,138,31
126,51948097-a988-43db-820e-ed4b05e21f44,36663127,1234,1107,127,32
126,51948097-a988-43db-820e-ed4b05e21f44,36663127,1796,1248,548,34
126,51948097-a988-43db-820e-ed4b05e21f44,36663127,2015,1800,215,35
126,51948097-a988-43db-820e-ed4b05e21f44,36663127,2270,2027,243,36
126,51948097-a988-43db-820e-ed4b05e21f44,36663127,2348,2275,73,40
126,51948097-a988-43db-820e-ed4b05e21f44,36663127,2330,2118,-212,50
126,51948097-a988-43db-820e-ed4b05e21f44,36663127,2102,1287,-815,51
126,51948097-a988-43db-820e-ed4b05e21f44,36663127,1286,1285,-1,52
126,51948097-a988-43db-820e-ed4b05e21f44,36663127,1260,884,-376,56
126,51948097-a988-43db-820e-ed4b05e21f44,36663127,868,850,-18,57
126,51948097-a988-43db-820e-ed4b05e21f44,36663127,831,276,-555,58
126,51948097-a988-43db-820e-ed4b05e21f44,36663127,371,277,94,60
126,51948097-a988-43db-820e-ed4b05e21f44,36663127,372,372,0,61
133,4bf13806-3d36-403d-be06-48373c6e0f0c,36662684,398,9,389,0
133,4bf13806-3d36-403d-be06-48373c6e0f0c,36662684,868,413,455,3
133,4bf13806-3d36-403d-be06-48373c6e0f0c,36662684,879,871,8,4
133,4bf13806-3d36-403d-be06-48373c6e0f0c,36662684,1409,884,525,12
133,4bf13806-3d36-403d-be06-48373c6e0f0c,36662684,2039,1412,627,16
133,4bf13806-3d36-403d-be06-48373c6e0f0c,36662684,2539,2046,493,17
133,4bf13806-3d36-403d-be06-48373c6e0f0c,36662684,2552,2542,10,18
133,4bf13806-3d36-403d-be06-48373c6e0f0c,36662684,2982,2560,422,20
133,4bf13806-3d36-403d-be06-48373c6e0f0c,36662684,3047,2987,60,21
133,4bf13806-3d36-403d-be06-48373c6e0f0c,36662684,3774,3072,702,79
133,4bf13806-3d36-403d-be06-48373c6e0f0c,36662684,4569,3776,793,80
133,4bf13806-3d36-403d-be06-48373c6e0f0c,36662684,5820,4637,1183,81
133,4bf13806-3d36-403d-be06-48373c6e0f0c,36662684,7018,5843,1175,82
133,4bf13806-3d36-403d-be06-48373c6e0f0c,36662684,7882,7057,825,83
133,4bf13806-3d36-403d-be06-48373c6e0f0c,36662684,8506,7883,623,84
133,4bf13806-3d36-403d-be06-48373c6e0f0c,36638178,256,8,248,0
133,4bf13806-3d36-403d-be06-48373c6e0f0c,36638178,289,262,27,1
133,4bf13806-3d36-403d-be06-48373c6e0f0c,36638178,667,291,376,7
133,4bf13806-3d36-403d-be06-48373c6e0f0c,36638178,773,678,95,9
133,4bf13806-3d36-403d-be06-48373c6e0f0c,36638178,1085,795,290,10
133,4bf13806-3d36-403d-be06-48373c6e0f0c,36638178,1171,1096,75,13
133,4bf13806-3d36-403d-be06-48373c6e0f0c,36638178,1455,1191,264,14
133,4bf13806-3d36-403d-be06-48373c6e0f0c,36638178,1974,1458,516,17
133,4bf13806-3d36-403d-be06-48373c6e0f0c,36638178,2448,1981,467,19
133,4bf13806-3d36-403d-be06-48373c6e0f0c,36638178,2608,2453,155,20
251,fb1b1b64-97d7-454a-82ef-5f39244c37ce,36660133,479,10,469,0
251,fb1b1b64-97d7-454a-82ef-5f39244c37ce,36660133,739,492,247,2
133,4bf13806-3d36-403d-be06-48373c6e0f0c,36661402,378,12,366,0
133,4bf13806-3d36-403d-be06-48373c6e0f0c,36661402,421,386,35,1
133,4bf13806-3d36-403d-be06-48373c6e0f0c,36661402,808,436,372,3
133,4bf13806-3d36-403d-be06-48373c6e0f0c,36661402,1078,813,265,6
133,4bf13806-3d36-403d-be06-48373c6e0f0c,36661402,1041,319,-722,8
133,4bf13806-3d36-403d-be06-48373c6e0f0c,36661402,184,0,-184,9
133,4bf13806-3d36-403d-be06-48373c6e0f0c,36661402,1078,32,1046,11
133,4bf13806-3d36-403d-be06-48373c6e0f0c,36661402,1035,0,-1035,12
133,4bf13806-3d36-403d-be06-48373c6e0f0c,36661402,1078,28,1050,13
133,4bf13806-3d36-403d-be06-48373c6e0f0c,36661402,1078,0,1078,14
251,7c59963a-ef76-4750-ad09-e0558f1dea09,36669137,207,5,202,0
251,7c59963a-ef76-4750-ad09-e0558f1dea09,36669137,213,0,-213,1
251,7c59963a-ef76-4750-ad09-e0558f1dea09,36669137,366,9,357,4
251,7c59963a-ef76-4750-ad09-e0558f1dea09,36669137,897,381,516,5
251,7c59963a-ef76-4750-ad09-e0558f1dea09,36669137,1185,910,275,6
251,7c59963a-ef76-4750-ad09-e0558f1dea09,36669137,1261,1189,72,9
251,7c59963a-ef76-4750-ad09-e0558f1dea09,36669137,1605,1272,333,10
251,7c59963a-ef76-4750-ad09-e0558f1dea09,36669137,1630,1613,17,11
251,7c59963a-ef76-4750-ad09-e0558f1dea09,36669137,1804,1638,166,15
251,7c59963a-ef76-4750-ad09-e0558f1dea09,36662592,71,13,58,0
251,7c59963a-ef76-4750-ad09-e0558f1dea09,36662592,585,91,494,1
251,7c59963a-ef76-4750-ad09-e0558f1dea09,36662592,915,591,324,2
251,7c59963a-ef76-4750-ad09-e0558f1dea09,36662592,961,918,43,3
251,7c59963a-ef76-4750-ad09-e0558f1dea09,36662592,1174,965,209,6
251,7c59963a-ef76-4750-ad09-e0558f1dea09,36662592,1204,1185,19,7
251,7c59963a-ef76-4750-ad09-e0558f1dea09,36662592,1358,1205,153,9
251,7c59963a-ef76-4750-ad09-e0558f1dea09,36662592,1480,1363,117,10
251,7c59963a-ef76-4750-ad09-e0558f1dea09,36662592,1669,1485,184,13
251,7c59963a-ef76-4750-ad09-e0558f1dea09,36662592,1870,1678,192,14
251,7c59963a-ef76-4750-ad09-e0558f1dea09,36662592,2041,1872,169,17
251,7c59963a-ef76-4750-ad09-e0558f1dea09,36662592,2171,2043,128,18
251,7c59963a-ef76-4750-ad09-e0558f1dea09,36662592,2422,2183,239,19
251,7c59963a-ef76-4750-ad09-e0558f1dea09,36662592,2618,2427,191,22
251,7c59963a-ef76-4750-ad09-e0558f1dea09,36662592,2629,2622,7,23
251,7c59963a-ef76-4750-ad09-e0558f1dea09,36662592,2760,2637,123,25
251,7c59963a-ef76-4750-ad09-e0558f1dea09,36662592,2821,2763,58,26
251,7c59963a-ef76-4750-ad09-e0558f1dea09,36662592,2822,2822,0,27
251,7c59963a-ef76-4750-ad09-e0558f1dea09,36662592,3020,2824,196,31
251,7c59963a-ef76-4750-ad09-e0558f1dea09,36662592,3095,3024,71,32
251,7c59963a-ef76-4750-ad09-e0558f1dea09,36662592,3299,3104,195,43
251,7c59963a-ef76-4750-ad09-e0558f1dea09,36662592,3317,3308,9,44
251,7c59963a-ef76-4750-ad09-e0558f1dea09,36662592,3509,3325,184,46
130,1f4d5c38-84d1-4644-99f7-b3876d866ef4,36671336,87,8,79,0
130,1f4d5c38-84d1-4644-99f7-b3876d866ef4,36671336,57,0,-57,2
127,a2880231-3c28-4abd-9ce6-2fa4342203d9,36672001,129,3,126,0
127,a2880231-3c28-4abd-9ce6-2fa4342203d9,36672001,235,132,103,1
127,a2880231-3c28-4abd-9ce6-2fa4342203d9,36672001,307,245,62,11
127,a2880231-3c28-4abd-9ce6-2fa4342203d9,36672001,372,319,53,12
127,a2880231-3c28-4abd-9ce6-2fa4342203d9,36672001,568,373,195,19
127,a2880231-3c28-4abd-9ce6-2fa4342203d9,36672001,610,576,34,20
127,a2880231-3c28-4abd-9ce6-2fa4342203d9,36672001,695,623,72,21
127,a2880231-3c28-4abd-9ce6-2fa4342203d9,36672001,955,698,257,28
127,a2880231-3c28-4abd-9ce6-2fa4342203d9,36672001,1135,959,176,31
127,a2880231-3c28-4abd-9ce6-2fa4342203d9,36672001,1338,1143,195,37
127,a2880231-3c28-4abd-9ce6-2fa4342203d9,36672001,1603,1341,262,47
127,a2880231-3c28-4abd-9ce6-2fa4342203d9,36672001,1817,1614,203,51
127,a2880231-3c28-4abd-9ce6-2fa4342203d9,36672001,1980,1826,154,52
250,84f7d78b-767a-4b1d-98e4-dd7d22c26f50,36672591,751,2,749,0
250,84f7d78b-767a-4b1d-98e4-dd7d22c26f50,36672591,855,773,82,1
250,84f7d78b-767a-4b1d-98e4-dd7d22c26f50,36672591,1066,866,200,11
250,84f7d78b-767a-4b1d-98e4-dd7d22c26f50,36672591,1757,1068,689,13
250,84f7d78b-767a-4b1d-98e4-dd7d22c26f50,36672591,2390,1741,649,16
250,84f7d78b-767a-4b1d-98e4-dd7d22c26f50,36672591,2443,2408,35,17
250,84f7d78b-767a-4b1d-98e4-dd7d22c26f50,36672591,2783,2507,276,21
250,84f7d78b-767a-4b1d-98e4-dd7d22c26f50,36672591,5283,2788,2495,28
250,84f7d78b-767a-4b1d-98e4-dd7d22c26f50,36672591,5202,4612,-590,29
250,84f7d78b-767a-4b1d-98e4-dd7d22c26f50,36672591,4406,0,-4406,30
250,1dc21c0f-c0d8-4411-ba62-1d1c1f7fc47c,36613679,788,69,719,0
250,1dc21c0f-c0d8-4411-ba62-1d1c1f7fc47c,36613679,1544,848,696,1
250,1dc21c0f-c0d8-4411-ba62-1d1c1f7fc47c,36613679,1908,1580,328,16
250,1dc21c0f-c0d8-4411-ba62-1d1c1f7fc47c,36613679,2156,1948,208,17
250,1dc21c0f-c0d8-4411-ba62-1d1c1f7fc47c,36613679,3199,2186,1013,18
250,1dc21c0f-c0d8-4411-ba62-1d1c1f7fc47c,36613679,3386,3202,184,35
250,1dc21c0f-c0d8-4411-ba62-1d1c1f7fc47c,36613679,3772,3397,375,47
250,1dc21c0f-c0d8-4411-ba62-1d1c1f7fc47c,36613679,4200,3779,421,48
250,1dc21c0f-c0d8-4411-ba62-1d1c1f7fc47c,36613679,4201,4201,0,49
250,1dc21c0f-c0d8-4411-ba62-1d1c1f7fc47c,36613679,4822,4219,603,55
250,1dc21c0f-c0d8-4411-ba62-1d1c1f7fc47c,36613679,5214,4849,365,56
251,02a76bc1-0d5b-43da-ad5c-f52c8472502c,36677028,299,13,286,0
251,02a76bc1-0d5b-43da-ad5c-f52c8472502c,36677028,437,308,129,2
251,02a76bc1-0d5b-43da-ad5c-f52c8472502c,36677028,606,440,166,3
251,02a76bc1-0d5b-43da-ad5c-f52c8472502c,36677028,792,613,179,8
251,02a76bc1-0d5b-43da-ad5c-f52c8472502c,36677028,924,801,123,12
251,02a76bc1-0d5b-43da-ad5c-f52c8472502c,36677028,1015,925,90,15
251,02a76bc1-0d5b-43da-ad5c-f52c8472502c,36677028,1096,1020,76,16
251,02a76bc1-0d5b-43da-ad5c-f52c8472502c,36677028,1208,1101,107,17
251,02a76bc1-0d5b-43da-ad5c-f52c8472502c,36677028,1299,1214,85,20
251,02a76bc1-0d5b-43da-ad5c-f52c8472502c,36677028,1342,1308,34,21
251,02a76bc1-0d5b-43da-ad5c-f52c8472502c,36677028,1390,1349,41,23
251,02a76bc1-0d5b-43da-ad5c-f52c8472502c,36677028,1657,1403,254,24
251,02a76bc1-0d5b-43da-ad5c-f52c8472502c,36677028,1784,1660,124,26
251,02a76bc1-0d5b-43da-ad5c-f52c8472502c,36677028,1823,1790,33,31
251,02a76bc1-0d5b-43da-ad5c-f52c8472502c,36677028,1918,1840,78,32
251,02a76bc1-0d5b-43da-ad5c-f52c8472502c,36677028,2359,1925,434,34
251,02a76bc1-0d5b-43da-ad5c-f52c8472502c,36677028,2529,2364,165,35
251,02a76bc1-0d5b-43da-ad5c-f52c8472502c,36677028,2738,2533,205,37
251,02a76bc1-0d5b-43da-ad5c-f52c8472502c,36677028,2983,2749,234,38
251,02a76bc1-0d5b-43da-ad5c-f52c8472502c,36677028,3201,2985,216,40
251,02a76bc1-0d5b-43da-ad5c-f52c8472502c,36677028,3237,3208,29,41
251,02a76bc1-0d5b-43da-ad5c-f52c8472502c,36677028,4556,3260,1296,42
251,02a76bc1-0d5b-43da-ad5c-f52c8472502c,36677028,6620,4633,1987,43
8,3db79b26-5b9f-4e58-97e7-45a8b790b55b,36684452,1047,61,986,0
8,3db79b26-5b9f-4e58-97e7-45a8b790b55b,36684452,3256,1147,2109,1
251,888e1bbd-ade7-4a31-8b69-76f1014afef9,36613679,487,3,484,0
251,888e1bbd-ade7-4a31-8b69-76f1014afef9,36613679,985,538,447,1
251,888e1bbd-ade7-4a31-8b69-76f1014afef9,36613679,1157,993,164,5
251,888e1bbd-ade7-4a31-8b69-76f1014afef9,36613679,1264,1161,103,6
251,888e1bbd-ade7-4a31-8b69-76f1014afef9,36613679,1507,1265,242,8
251,888e1bbd-ade7-4a31-8b69-76f1014afef9,36613679,1537,1509,28,9
251,888e1bbd-ade7-4a31-8b69-76f1014afef9,36613679,1850,1538,312,20
251,888e1bbd-ade7-4a31-8b69-76f1014afef9,36613679,2022,1859,163,21
251,888e1bbd-ade7-4a31-8b69-76f1014afef9,36613679,2325,2037,288,23
251,888e1bbd-ade7-4a31-8b69-76f1014afef9,36613679,2804,2338,466,24
251,888e1bbd-ade7-4a31-8b69-76f1014afef9,36613679,3053,2824,229,25
251,888e1bbd-ade7-4a31-8b69-76f1014afef9,36613679,3062,3057,5,26
251,888e1bbd-ade7-4a31-8b69-76f1014afef9,36613679,3293,3069,224,30
251,888e1bbd-ade7-4a31-8b69-76f1014afef9,36613679,3484,3300,184,36
251,888e1bbd-ade7-4a31-8b69-76f1014afef9,36613679,5001,3486,1515,37
251,888e1bbd-ade7-4a31-8b69-76f1014afef9,36613679,5006,5003,3,38
259,f0e586c8-91a0-410e-b75c-63856d0d37c8,36692613,42,5,37,0
259,f0e586c8-91a0-410e-b75c-63856d0d37c8,36692613,128,43,85,6
259,f0e586c8-91a0-410e-b75c-63856d0d37c8,36692613,762,132,630,8
259,f0e586c8-91a0-410e-b75c-63856d0d37c8,36692613,769,123,-646,9
259,f0e586c8-91a0-410e-b75c-63856d0d37c8,36692613,615,118,497,10
259,f0e586c8-91a0-410e-b75c-63856d0d37c8,36692613,650,620,30,15
259,f0e586c8-91a0-410e-b75c-63856d0d37c8,36692613,671,653,18,16
259,f0e586c8-91a0-410e-b75c-63856d0d37c8,36692613,1546,672,874,17
259,f0e586c8-91a0-410e-b75c-63856d0d37c8,36692613,1784,1570,214,18
250,1e2f2ec7-3bcd-4403-809d-5e419aac85a8,36682140,81,6,75,0
250,1e2f2ec7-3bcd-4403-809d-5e419aac85a8,36682140,270,99,171,1
250,1e2f2ec7-3bcd-4403-809d-5e419aac85a8,36682140,248,150,-98,6
250,1e2f2ec7-3bcd-4403-809d-5e419aac85a8,36682140,377,130,247,7
250,1e2f2ec7-3bcd-4403-809d-5e419aac85a8,36682140,387,378,9,8
250,1e2f2ec7-3bcd-4403-809d-5e419aac85a8,36682140,329,59,-270,9
250,1e2f2ec7-3bcd-4403-809d-5e419aac85a8,36682140,111,50,61,10
250,1e2f2ec7-3bcd-4403-809d-5e419aac85a8,36682140,129,113,16,11
250,1e2f2ec7-3bcd-4403-809d-5e419aac85a8,36682140,261,135,126,26
250,1e2f2ec7-3bcd-4403-809d-5e419aac85a8,36682140,316,269,47,27
250,1e2f2ec7-3bcd-4403-809d-5e419aac85a8,36682140,1912,417,1495,28
250,1e2f2ec7-3bcd-4403-809d-5e419aac85a8,36682140,1935,1420,-515,29
250,1e2f2ec7-3bcd-4403-809d-5e419aac85a8,36682140,1787,1430,357,32
250,1e2f2ec7-3bcd-4403-809d-5e419aac85a8,36682140,2089,1789,300,34
250,1e2f2ec7-3bcd-4403-809d-5e419aac85a8,36682140,2415,2090,325,35
250,1e2f2ec7-3bcd-4403-809d-5e419aac85a8,36682140,2505,2429,76,36
250,1e2f2ec7-3bcd-4403-809d-5e419aac85a8,36682140,3276,2518,758,37
250,1e2f2ec7-3bcd-4403-809d-5e419aac85a8,36682140,3489,3303,186,38
250,1e2f2ec7-3bcd-4403-809d-5e419aac85a8,36682140,3462,3345,-117,39
250,1e2f2ec7-3bcd-4403-809d-5e419aac85a8,36682140,3343,3337,-6,40
250,1e2f2ec7-3bcd-4403-809d-5e419aac85a8,36682140,3489,3339,150,42
250,1e2f2ec7-3bcd-4403-809d-5e419aac85a8,36682140,3481,3157,-324,48
250,1e2f2ec7-3bcd-4403-809d-5e419aac85a8,36682140,3122,2237,-885,49
250,1e2f2ec7-3bcd-4403-809d-5e419aac85a8,36682140,2191,1809,-382,50
250,1e2f2ec7-3bcd-4403-809d-5e419aac85a8,36607608,588,16,572,0
250,1e2f2ec7-3bcd-4403-809d-5e419aac85a8,36607608,911,592,319,4
250,1e2f2ec7-3bcd-4403-809d-5e419aac85a8,36607608,1253,933,320,5
250,1e2f2ec7-3bcd-4403-809d-5e419aac85a8,36607608,1886,1260,626,6
250,1e2f2ec7-3bcd-4403-809d-5e419aac85a8,36607608,2118,1902,216,18
250,1e2f2ec7-3bcd-4403-809d-5e419aac85a8,36607608,2495,2156,339,19
250,1e2f2ec7-3bcd-4403-809d-5e419aac85a8,36607608,2742,2504,238,20
250,1e2f2ec7-3bcd-4403-809d-5e419aac85a8,36607608,3055,2752,303,21
250,1e2f2ec7-3bcd-4403-809d-5e419aac85a8,36607608,3105,3067,38,22
250,1e2f2ec7-3bcd-4403-809d-5e419aac85a8,36607608,3764,3110,654,23
250,1e2f2ec7-3bcd-4403-809d-5e419aac85a8,36607608,4429,3771,658,24
250,1e2f2ec7-3bcd-4403-809d-5e419aac85a8,36607608,4487,4437,50,25
250,1e2f2ec7-3bcd-4403-809d-5e419aac85a8,36607608,5345,4493,852,32
250,1e2f2ec7-3bcd-4403-809d-5e419aac85a8,36607608,5924,5375,549,33
250,1e2f2ec7-3bcd-4403-809d-5e419aac85a8,36607608,6879,6003,876,57
250,1e2f2ec7-3bcd-4403-809d-5e419aac85a8,36607608,6873,6606,-267,58
250,1e2f2ec7-3bcd-4403-809d-5e419aac85a8,36607608,6560,5584,-976,59
250,1e2f2ec7-3bcd-4403-809d-5e419aac85a8,36607608,5579,4679,-900,61
250,1e2f2ec7-3bcd-4403-809d-5e419aac85a8,36607608,4614,2634,-1980,62
250,1e2f2ec7-3bcd-4403-809d-5e419aac85a8,36607608,2628,2609,-19,63
250,1e2f2ec7-3bcd-4403-809d-5e419aac85a8,36607608,2509,1105,-1404,64
250,1e2f2ec7-3bcd-4403-809d-5e419aac85a8,36607608,1003,0,-1003,65
259,e2f4c2a9-14b6-474b-ab60-db95aeb15582,36696568,189,22,167,0
259,e2f4c2a9-14b6-474b-ab60-db95aeb15582,36696568,130,129,-1,1
259,e2f4c2a9-14b6-474b-ab60-db95aeb15582,36696568,87,0,-87,2
259,e2f4c2a9-14b6-474b-ab60-db95aeb15582,36696568,178,3,175,3
259,e2f4c2a9-14b6-474b-ab60-db95aeb15582,36696568,255,151,104,7
259,e2f4c2a9-14b6-474b-ab60-db95aeb15582,36696568,595,260,335,8
259,e2f4c2a9-14b6-474b-ab60-db95aeb15582,36696568,724,604,120,9
259,e2f4c2a9-14b6-474b-ab60-db95aeb15582,36696568,1015,727,288,10
259,e2f4c2a9-14b6-474b-ab60-db95aeb15582,36696568,1098,1020,78,11
259,e2f4c2a9-14b6-474b-ab60-db95aeb15582,36696568,1489,1101,388,16
259,e2f4c2a9-14b6-474b-ab60-db95aeb15582,36696568,1571,1504,67,17
259,e2f4c2a9-14b6-474b-ab60-db95aeb15582,36695497,395,7,388,0
259,e2f4c2a9-14b6-474b-ab60-db95aeb15582,36695497,468,407,61,1
259,e2f4c2a9-14b6-474b-ab60-db95aeb15582,36695497,412,0,-412,2
259,e2f4c2a9-14b6-474b-ab60-db95aeb15582,36695497,480,30,450,11
250,aa948803-9b2d-4563-a782-8061470e3403,36698055,998,28,970,0
250,aa948803-9b2d-4563-a782-8061470e3403,36698055,1275,1023,252,44
250,aa948803-9b2d-4563-a782-8061470e3403,36686682,32,32,0,0
250,aa948803-9b2d-4563-a782-8061470e3403,36686682,861,76,785,1
250,aa948803-9b2d-4563-a782-8061470e3403,36686682,1703,904,799,25
250,aa948803-9b2d-4563-a782-8061470e3403,36686682,1718,1706,12,26
250,aa948803-9b2d-4563-a782-8061470e3403,36686682,2107,1729,378,53
250,aa948803-9b2d-4563-a782-8061470e3403,36686682,2199,2116,83,54
250,aa948803-9b2d-4563-a782-8061470e3403,36686682,3332,2200,1132,57
250,aa948803-9b2d-4563-a782-8061470e3403,36686682,3335,3180,-155,58
250,aa948803-9b2d-4563-a782-8061470e3403,36686682,3648,3210,438,65
250,aa948803-9b2d-4563-a782-8061470e3403,36686682,4151,3665,486,66
250,aa948803-9b2d-4563-a782-8061470e3403,36686682,4305,4152,153,67
250,aa948803-9b2d-4563-a782-8061470e3403,36686682,4413,4327,86,68
250,aa948803-9b2d-4563-a782-8061470e3403,36686682,4569,4415,154,70
250,aa948803-9b2d-4563-a782-8061470e3403,36686682,4569,4568,1,71
250,3ea51445-accf-4442-bad1-617f81eae9e9,36682598,414,9,405,0
250,3ea51445-accf-4442-bad1-617f81eae9e9,36682598,360,0,-360,6
250,3ea51445-accf-4442-bad1-617f81eae9e9,36682598,812,62,750,7
250,3ea51445-accf-4442-bad1-617f81eae9e9,36682598,839,814,25,8
250,3ea51445-accf-4442-bad1-617f81eae9e9,36682598,944,856,88,10
250,3ea51445-accf-4442-bad1-617f81eae9e9,36682598,2109,1008,1101,11
259,2945e0de-ceb8-4757-ae84-833e5086b1d4,36697443,511,6,505,0
259,2945e0de-ceb8-4757-ae84-833e5086b1d4,36697443,566,515,51,8
259,2945e0de-ceb8-4757-ae84-833e5086b1d4,36697443,638,563,75,10
259,2945e0de-ceb8-4757-ae84-833e5086b1d4,36697443,638,638,0,12
259,2945e0de-ceb8-4757-ae84-833e5086b1d4,36697323,107,8,99,0
259,2945e0de-ceb8-4757-ae84-833e5086b1d4,36697323,151,108,43,1
259,2945e0de-ceb8-4757-ae84-833e5086b1d4,36697323,372,160,212,10
259,2945e0de-ceb8-4757-ae84-833e5086b1d4,36697323,372,371,1,11
259,b97a80b7-2580-4470-80e3-2689ebda786f,36697713,7,2,5,0
259,b97a80b7-2580-4470-80e3-2689ebda786f,36697713,195,14,181,1
259,b97a80b7-2580-4470-80e3-2689ebda786f,36697713,282,196,86,4
259,b97a80b7-2580-4470-80e3-2689ebda786f,36697713,338,286,52,5
259,b97a80b7-2580-4470-80e3-2689ebda786f,36699036,228,3,225,0
259,b97a80b7-2580-4470-80e3-2689ebda786f,36699036,338,232,106,1
259,b97a80b7-2580-4470-80e3-2689ebda786f,36699036,362,339,23,2
259,b97a80b7-2580-4470-80e3-2689ebda786f,36699036,416,377,39,3
250,1e348ae3-069a-4bf0-a2d1-b9d56504acd2,36700080,292,3,289,0
250,1e348ae3-069a-4bf0-a2d1-b9d56504acd2,36700080,370,192,178,3
250,1e348ae3-069a-4bf0-a2d1-b9d56504acd2,36700080,896,383,513,4
250,1e348ae3-069a-4bf0-a2d1-b9d56504acd2,36700080,1208,929,279,5
250,1e348ae3-069a-4bf0-a2d1-b9d56504acd2,36700080,1453,1222,231,14
250,1e348ae3-069a-4bf0-a2d1-b9d56504acd2,36700080,1771,1456,315,16
250,1e348ae3-069a-4bf0-a2d1-b9d56504acd2,36700080,2382,1791,591,17
250,1e348ae3-069a-4bf0-a2d1-b9d56504acd2,36700080,2913,2383,530,18
125,6b82f256-a283-46f9-be1c-f69e3c4895d9,36676576,237,9,228,0
125,6b82f256-a283-46f9-be1c-f69e3c4895d9,36676576,690,258,432,1
125,6b82f256-a283-46f9-be1c-f69e3c4895d9,36676576,690,358,332,4
125,6b82f256-a283-46f9-be1c-f69e3c4895d9,36699642,1047,44,1003,0
125,6b82f256-a283-46f9-be1c-f69e3c4895d9,36699642,2643,1062,1581,1
125,6b82f256-a283-46f9-be1c-f69e3c4895d9,36699642,2646,2644,2,2
258,06a293bb-c63d-44ca-89bb-b253c3e69b1d,36702468,142,3,139,0
258,06a293bb-c63d-44ca-89bb-b253c3e69b1d,36702468,333,155,178,1
258,06a293bb-c63d-44ca-89bb-b253c3e69b1d,36702468,300,0,-300,3
250,8ce51d10-7fa5-452f-88eb-02618369e008,36702468,304,1,303,0
250,8ce51d10-7fa5-452f-88eb-02618369e008,36702468,694,314,380,1
250,8ce51d10-7fa5-452f-88eb-02618369e008,36702468,1139,701,438,5
250,8ce51d10-7fa5-452f-88eb-02618369e008,36702468,1324,1142,182,6
250,8ce51d10-7fa5-452f-88eb-02618369e008,36702468,1941,1341,600,7
250,8ce51d10-7fa5-452f-88eb-02618369e008,36702468,1892,1467,-425,57
250,8ce51d10-7fa5-452f-88eb-02618369e008,36702468,1453,269,-1184,58
250,8ce51d10-7fa5-452f-88eb-02618369e008,36702468,266,0,-266,59
250,8ce51d10-7fa5-452f-88eb-02618369e008,36702468,510,29,481,162
250,8ce51d10-7fa5-452f-88eb-02618369e008,36702468,1014,527,487,164
250,8ce51d10-7fa5-452f-88eb-02618369e008,36702468,977,695,-282,166
250,8ce51d10-7fa5-452f-88eb-02618369e008,36702468,671,256,-415,170
250,8ce51d10-7fa5-452f-88eb-02618369e008,36702468,1255,310,945,178
250,8ce51d10-7fa5-452f-88eb-02618369e008,36702468,1941,1381,560,179
250,8ce51d10-7fa5-452f-88eb-02618369e008,36702468,1866,1866,0,289
250,8ce51d10-7fa5-452f-88eb-02618369e008,36702468,1941,1910,31,300
250,8ce51d10-7fa5-452f-88eb-02618369e008,36702336,217,3,214,0
250,8ce51d10-7fa5-452f-88eb-02618369e008,36702336,221,221,0,1
250,8ce51d10-7fa5-452f-88eb-02618369e008,36702336,654,239,415,2
250,8ce51d10-7fa5-452f-88eb-02618369e008,36702336,1054,655,399,3
250,8ce51d10-7fa5-452f-88eb-02618369e008,36702336,1012,639,-373,17
250,8ce51d10-7fa5-452f-88eb-02618369e008,36702336,631,0,-631,18
250,8ce51d10-7fa5-452f-88eb-02618369e008,36702336,518,5,513,19
250,8ce51d10-7fa5-452f-88eb-02618369e008,36702336,532,522,10,20
250,8ce51d10-7fa5-452f-88eb-02618369e008,36702336,1314,541,773,22
250,8ce51d10-7fa5-452f-88eb-02618369e008,36701273,653,55,598,0
250,8ce51d10-7fa5-452f-88eb-02618369e008,36701273,928,668,260,6
250,8ce51d10-7fa5-452f-88eb-02618369e008,36701273,1012,940,72,7
250,8ce51d10-7fa5-452f-88eb-02618369e008,36701273,1764,1057,707,11
250,8ce51d10-7fa5-452f-88eb-02618369e008,36701273,2166,1815,351,12
250,8ce51d10-7fa5-452f-88eb-02618369e008,36701273,1955,0,-1955,14
125,ec229e43-38c8-42bd-9209-15578f93daf9,36672285,708,6,702,0
125,ec229e43-38c8-42bd-9209-15578f93daf9,36672285,1158,723,435,1
125,ec229e43-38c8-42bd-9209-15578f93daf9,36672285,1609,1183,426,12
125,ec229e43-38c8-42bd-9209-15578f93daf9,36672285,1821,1621,200,13
125,ec229e43-38c8-42bd-9209-15578f93daf9,36672285,2111,1828,283,21
125,ec229e43-38c8-42bd-9209-15578f93daf9,36672285,2140,2113,27,22
125,ec229e43-38c8-42bd-9209-15578f93daf9,36672285,3426,2166,1260,28
125,ec229e43-38c8-42bd-9209-15578f93daf9,36672285,5744,3427,2317,29
259,a6201a15-8f8a-445d-a34a-b85dfb32306a,36706761,116,5,111,0
259,a6201a15-8f8a-445d-a34a-b85dfb32306a,36706761,168,117,51,1
259,a6201a15-8f8a-445d-a34a-b85dfb32306a,36706761,189,170,19,2
259,a6201a15-8f8a-445d-a34a-b85dfb32306a,36706761,190,190,0,3
259,a6201a15-8f8a-445d-a34a-b85dfb32306a,36706761,189,188,-1,4
259,a6201a15-8f8a-445d-a34a-b85dfb32306a,36702589,131,10,121,0
259,a6201a15-8f8a-445d-a34a-b85dfb32306a,36702589,264,132,132,1
259,a6201a15-8f8a-445d-a34a-b85dfb32306a,36702589,561,272,289,2
259,a6201a15-8f8a-445d-a34a-b85dfb32306a,36702589,589,562,27,3
259,a6201a15-8f8a-445d-a34a-b85dfb32306a,36702589,705,590,115,16
259,a6201a15-8f8a-445d-a34a-b85dfb32306a,36702589,755,710,45,17
259,a6201a15-8f8a-445d-a34a-b85dfb32306a,36702589,819,760,59,24
259,a6201a15-8f8a-445d-a34a-b85dfb32306a,36702589,1361,820,541,25
259,a6201a15-8f8a-445d-a34a-b85dfb32306a,36702589,1529,1379,150,26
259,a6201a15-8f8a-445d-a34a-b85dfb32306a,36702589,2720,1528,1192,27
259,a6201a15-8f8a-445d-a34a-b85dfb32306a,36702589,2740,2725,15,29
251,c557ee3d-a597-498e-a6c7-107aa7bdba47,36702468,160,8,152,0
251,c557ee3d-a597-498e-a6c7-107aa7bdba47,36702468,239,161,78,1
251,c557ee3d-a597-498e-a6c7-107aa7bdba47,36702468,295,241,54,2
251,c557ee3d-a597-498e-a6c7-107aa7bdba47,36702468,493,299,194,5
251,c557ee3d-a597-498e-a6c7-107aa7bdba47,36702468,495,494,1,6
251,c557ee3d-a597-498e-a6c7-107aa7bdba47,36702468,565,496,69,10
251,c557ee3d-a597-498e-a6c7-107aa7bdba47,36702468,628,567,61,11
251,c557ee3d-a597-498e-a6c7-107aa7bdba47,36702468,803,631,172,18
251,c557ee3d-a597-498e-a6c7-107aa7bdba47,36702468,853,807,46,19
251,c557ee3d-a597-498e-a6c7-107aa7bdba47,36702468,982,860,122,23
251,c557ee3d-a597-498e-a6c7-107aa7bdba47,36702468,1168,986,182,24
251,c557ee3d-a597-498e-a6c7-107aa7bdba47,36702468,1175,943,-232,25
251,c557ee3d-a597-498e-a6c7-107aa7bdba47,36702468,1030,952,78,26
251,c557ee3d-a597-498e-a6c7-107aa7bdba47,36702468,1289,1034,255,27
251,c557ee3d-a597-498e-a6c7-107aa7bdba47,36702468,1456,1298,158,29
251,c557ee3d-a597-498e-a6c7-107aa7bdba47,36702468,1572,1457,115,32
251,c557ee3d-a597-498e-a6c7-107aa7bdba47,36702468,1621,1576,45,33
251,c557ee3d-a597-498e-a6c7-107aa7bdba47,36702468,1848,1631,217,38
24,fcaeb519-5ef0-49f3-973a-1f965c899b58,36702468,39,2,37,0
24,fcaeb519-5ef0-49f3-973a-1f965c899b58,36702468,88,41,47,1
24,fcaeb519-5ef0-49f3-973a-1f965c899b58,36702468,149,89,60,2
24,fcaeb519-5ef0-49f3-973a-1f965c899b58,36702468,202,151,51,3
24,fcaeb519-5ef0-49f3-973a-1f965c899b58,36702468,251,204,47,4
24,fcaeb519-5ef0-49f3-973a-1f965c899b58,36702468,255,253,2,5
24,fcaeb519-5ef0-49f3-973a-1f965c899b58,36702468,307,256,51,19
24,fcaeb519-5ef0-49f3-973a-1f965c899b58,36702468,498,315,183,20
24,fcaeb519-5ef0-49f3-973a-1f965c899b58,36702468,608,506,102,21
24,fcaeb519-5ef0-49f3-973a-1f965c899b58,36702468,732,611,121,40
24,fcaeb519-5ef0-49f3-973a-1f965c899b58,36702468,826,738,88,41
24,fcaeb519-5ef0-49f3-973a-1f965c899b58,36702468,923,829,94,42
24,fcaeb519-5ef0-49f3-973a-1f965c899b58,36702468,945,909,-36,43
24,fcaeb519-5ef0-49f3-973a-1f965c899b58,36702468,905,886,-19,44
24,fcaeb519-5ef0-49f3-973a-1f965c899b58,36702468,938,887,51,46
24,fcaeb519-5ef0-49f3-973a-1f965c899b58,36702468,981,940,41,47
24,fcaeb519-5ef0-49f3-973a-1f965c899b58,36702468,1043,983,60,48
24,fcaeb519-5ef0-49f3-973a-1f965c899b58,36702468,1049,1045,4,49
24,fcaeb519-5ef0-49f3-973a-1f965c899b58,36702468,1610,1050,560,60
24,fcaeb519-5ef0-49f3-973a-1f965c899b58,36702468,2616,1621,995,61
24,fcaeb519-5ef0-49f3-973a-1f965c899b58,36707573,47,1,46,0
24,fcaeb519-5ef0-49f3-973a-1f965c899b58,36707573,158,50,108,1
24,fcaeb519-5ef0-49f3-973a-1f965c899b58,36707573,233,161,72,2
250,f113cdbc-c03b-4cc4-bc3d-de4c005301ec,36706761,407,1,406,0
250,f113cdbc-c03b-4cc4-bc3d-de4c005301ec,36706761,434,409,25,5
250,f113cdbc-c03b-4cc4-bc3d-de4c005301ec,36706761,815,440,375,6
250,f113cdbc-c03b-4cc4-bc3d-de4c005301ec,36706761,1276,832,444,13
250,f113cdbc-c03b-4cc4-bc3d-de4c005301ec,36706761,1584,1279,305,19
250,f113cdbc-c03b-4cc4-bc3d-de4c005301ec,36706761,1820,1608,212,20
250,f113cdbc-c03b-4cc4-bc3d-de4c005301ec,36706761,2217,1825,392,22
250,f113cdbc-c03b-4cc4-bc3d-de4c005301ec,36706761,2926,2234,692,23
250,f113cdbc-c03b-4cc4-bc3d-de4c005301ec,36706761,3549,2928,621,24
250,f113cdbc-c03b-4cc4-bc3d-de4c005301ec,36706761,3861,3551,310,25
250,f113cdbc-c03b-4cc4-bc3d-de4c005301ec,36706761,3852,3422,-430,29
250,f113cdbc-c03b-4cc4-bc3d-de4c005301ec,36710667,565,24,541,0
250,f113cdbc-c03b-4cc4-bc3d-de4c005301ec,36710667,786,568,218,1
250,f113cdbc-c03b-4cc4-bc3d-de4c005301ec,36710667,919,798,121,2
250,f113cdbc-c03b-4cc4-bc3d-de4c005301ec,36710667,1056,937,119,6
126,36c808dc-abe0-4e2d-a0b1-bd6e28b3379c,36710828,522,7,515,0
126,36c808dc-abe0-4e2d-a0b1-bd6e28b3379c,36710828,533,525,8,1
126,36c808dc-abe0-4e2d-a0b1-bd6e28b3379c,36710828,579,535,44,14
126,36c808dc-abe0-4e2d-a0b1-bd6e28b3379c,36710828,664,589,75,15
126,36c808dc-abe0-4e2d-a0b1-bd6e28b3379c,36710828,664,662,2,25
126,36c808dc-abe0-4e2d-a0b1-bd6e28b3379c,36710828,663,645,-18,26
126,36c808dc-abe0-4e2d-a0b1-bd6e28b3379c,36710828,646,92,-554,27
126,36c808dc-abe0-4e2d-a0b1-bd6e28b3379c,36710828,88,75,-13,28
250,77c0d629-ce2a-4103-8157-fccc93d62d62,36712040,525,12,513,0
250,77c0d629-ce2a-4103-8157-fccc93d62d62,36712040,829,540,289,3
250,77c0d629-ce2a-4103-8157-fccc93d62d62,36712040,1071,848,223,4
250,77c0d629-ce2a-4103-8157-fccc93d62d62,36712040,1195,1072,123,8
250,77c0d629-ce2a-4103-8157-fccc93d62d62,36712040,1603,1225,378,9
250,77c0d629-ce2a-4103-8157-fccc93d62d62,36712040,2085,1605,480,15
250,77c0d629-ce2a-4103-8157-fccc93d62d62,36712040,2253,2087,166,16
250,77c0d629-ce2a-4103-8157-fccc93d62d62,36712040,2707,2296,411,17
250,77c0d629-ce2a-4103-8157-fccc93d62d62,36712040,2982,2714,268,19
250,77c0d629-ce2a-4103-8157-fccc93d62d62,36712040,3139,2984,155,21
250,77c0d629-ce2a-4103-8157-fccc93d62d62,36712040,3250,3154,96,22
250,77c0d629-ce2a-4103-8157-fccc93d62d62,36712040,3692,3254,438,24
250,77c0d629-ce2a-4103-8157-fccc93d62d62,36712040,4515,3729,786,25
250,77c0d629-ce2a-4103-8157-fccc93d62d62,36712040,4475,4052,-423,28
250,77c0d629-ce2a-4103-8157-fccc93d62d62,36707255,463,10,453,0
250,77c0d629-ce2a-4103-8157-fccc93d62d62,36707255,911,476,435,2
250,77c0d629-ce2a-4103-8157-fccc93d62d62,36707255,1234,915,319,4
250,77c0d629-ce2a-4103-8157-fccc93d62d62,36707255,1325,1320,5,5
250,77c0d629-ce2a-4103-8157-fccc93d62d62,36707255,1390,1362,28,8
250,77c0d629-ce2a-4103-8157-fccc93d62d62,36707255,1669,1419,250,9
250,77c0d629-ce2a-4103-8157-fccc93d62d62,36707255,2114,1679,435,16
250,77c0d629-ce2a-4103-8157-fccc93d62d62,36707255,2202,2120,82,18
250,77c0d629-ce2a-4103-8157-fccc93d62d62,36707255,2451,2218,233,19
250,77c0d629-ce2a-4103-8157-fccc93d62d62,36707255,2868,2466,402,22
250,77c0d629-ce2a-4103-8157-fccc93d62d62,36707255,3285,2875,410,24
250,77c0d629-ce2a-4103-8157-fccc93d62d62,36707255,3501,3298,203,26
250,77c0d629-ce2a-4103-8157-fccc93d62d62,36707255,3978,3531,447,27
250,77c0d629-ce2a-4103-8157-fccc93d62d62,36707255,6058,4014,2044,28
250,77c0d629-ce2a-4103-8157-fccc93d62d62,36707255,7671,6142,1529,29
250,77c0d629-ce2a-4103-8157-fccc93d62d62,36651699,603,44,559,0
250,77c0d629-ce2a-4103-8157-fccc93d62d62,36651699,940,607,333,4
250,77c0d629-ce2a-4103-8157-fccc93d62d62,36651699,1055,962,93,5
250,77c0d629-ce2a-4103-8157-fccc93d62d62,36651699,1497,1063,434,6
250,77c0d629-ce2a-4103-8157-fccc93d62d62,36651699,1451,953,-498,88
250,77c0d629-ce2a-4103-8157-fccc93d62d62,36651699,939,894,-45,89
250,77c0d629-ce2a-4103-8157-fccc93d62d62,36651699,889,0,-889,97
250,77c0d629-ce2a-4103-8157-fccc93d62d62,36651699,493,4,489,98
250,77c0d629-ce2a-4103-8157-fccc93d62d62,36651699,1203,512,691,99
250,77c0d629-ce2a-4103-8157-fccc93d62d62,36651699,1549,1206,343,100
250,77c0d629-ce2a-4103-8157-fccc93d62d62,36651699,2018,1563,455,106
250,77c0d629-ce2a-4103-8157-fccc93d62d62,36651699,2101,2020,81,107
250,77c0d629-ce2a-4103-8157-fccc93d62d62,36651699,2593,2106,487,119
250,77c0d629-ce2a-4103-8157-fccc93d62d62,36651699,2605,2596,9,120
250,77c0d629-ce2a-4103-8157-fccc93d62d62,36651699,2625,2612,13,121
250,77c0d629-ce2a-4103-8157-fccc93d62d62,36651699,2888,2645,243,122
250,77c0d629-ce2a-4103-8157-fccc93d62d62,36651699,3244,2904,340,124
250,77c0d629-ce2a-4103-8157-fccc93d62d62,36651699,3635,3252,383,126
250,77c0d629-ce2a-4103-8157-fccc93d62d62,36651699,3978,3648,330,131
250,77c0d629-ce2a-4103-8157-fccc93d62d62,36651699,4232,3986,246,133
250,77c0d629-ce2a-4103-8157-fccc93d62d62,36651699,4238,4233,5,134
250,77c0d629-ce2a-4103-8157-fccc93d62d62,36651699,4521,4244,277,135
250,77c0d629-ce2a-4103-8157-fccc93d62d62,36651699,4521,4520,1,136
125,f00a9c32-e92e-4f26-9b81-8ef4d699482b,36713699,8,8,0,0
125,f00a9c32-e92e-4f26-9b81-8ef4d699482b,36713699,93,16,77,1
125,f00a9c32-e92e-4f26-9b81-8ef4d699482b,36713699,174,95,79,12
258,e88a195c-fb76-49a6-9fe9-8f67c2f3d76e,36717050,600,27,573,0
258,e88a195c-fb76-49a6-9fe9-8f67c2f3d76e,36717050,575,0,-575,2
250,cbb60f43-967b-4338-a3df-4b8834f02906,36711711,112,4,108,0
250,cbb60f43-967b-4338-a3df-4b8834f02906,36711711,204,116,88,1
250,cbb60f43-967b-4338-a3df-4b8834f02906,36711711,204,203,1,2
250,cbb60f43-967b-4338-a3df-4b8834f02906,36711711,188,145,-43,3
250,cbb60f43-967b-4338-a3df-4b8834f02906,36711711,204,0,204,4
250,cbb60f43-967b-4338-a3df-4b8834f02906,36712690,459,61,398,0
250,cbb60f43-967b-4338-a3df-4b8834f02906,36712690,500,473,27,1
250,cbb60f43-967b-4338-a3df-4b8834f02906,36712690,858,503,355,4
250,cbb60f43-967b-4338-a3df-4b8834f02906,36712690,984,984,0,5
250,cbb60f43-967b-4338-a3df-4b8834f02906,36712690,772,512,-260,10
250,cbb60f43-967b-4338-a3df-4b8834f02906,36712690,509,493,-16,11
250,cbb60f43-967b-4338-a3df-4b8834f02906,36712690,1143,494,649,12
250,cbb60f43-967b-4338-a3df-4b8834f02906,36712690,1598,1152,446,15
250,cbb60f43-967b-4338-a3df-4b8834f02906,36712690,1673,1603,70,16
250,cbb60f43-967b-4338-a3df-4b8834f02906,36712690,1936,1693,243,19
250,cbb60f43-967b-4338-a3df-4b8834f02906,36712690,1853,0,-1853,20
250,cbb60f43-967b-4338-a3df-4b8834f02906,36712690,279,2,277,21
250,cbb60f43-967b-4338-a3df-4b8834f02906,36712690,2377,317,2060,22
250,cbb60f43-967b-4338-a3df-4b8834f02906,36712690,2703,2378,325,24
250,cbb60f43-967b-4338-a3df-4b8834f02906,36711903,435,43,392,0
250,cbb60f43-967b-4338-a3df-4b8834f02906,36711903,457,441,16,1
250,cbb60f43-967b-4338-a3df-4b8834f02906,36711903,774,474,300,5
250,cbb60f43-967b-4338-a3df-4b8834f02906,36711903,1262,785,477,6
250,cbb60f43-967b-4338-a3df-4b8834f02906,36711903,1446,1269,177,7
250,cbb60f43-967b-4338-a3df-4b8834f02906,36711903,1576,1474,102,8
250,cbb60f43-967b-4338-a3df-4b8834f02906,36711903,1950,1600,350,10
250,cbb60f43-967b-4338-a3df-4b8834f02906,36711903,1989,1956,33,11
250,cbb60f43-967b-4338-a3df-4b8834f02906,36711903,2485,2013,472,15
250,cbb60f43-967b-4338-a3df-4b8834f02906,36711903,2523,2493,30,16
250,cbb60f43-967b-4338-a3df-4b8834f02906,36711903,3056,2556,500,17
250,cbb60f43-967b-4338-a3df-4b8834f02906,36711903,3525,3065,460,18
250,cbb60f43-967b-4338-a3df-4b8834f02906,36711903,3541,3541,0,21
250,cbb60f43-967b-4338-a3df-4b8834f02906,36711903,4109,3586,523,22
250,cbb60f43-967b-4338-a3df-4b8834f02906,36711903,4535,4127,408,23
250,cbb60f43-967b-4338-a3df-4b8834f02906,36711903,4666,4146,-520,24
250,cbb60f43-967b-4338-a3df-4b8834f02906,36711903,4112,3866,-246,25
250,cbb60f43-967b-4338-a3df-4b8834f02906,36711903,4399,3889,510,26
250,cbb60f43-967b-4338-a3df-4b8834f02906,36711903,4892,4402,490,27
250,cbb60f43-967b-4338-a3df-4b8834f02906,36711903,4894,4894,0,28
250,cbb60f43-967b-4338-a3df-4b8834f02906,36711903,4875,4749,-126,30
250,cbb60f43-967b-4338-a3df-4b8834f02906,36711903,4686,4353,-333,31
250,cbb60f43-967b-4338-a3df-4b8834f02906,36711903,4974,4356,618,38
250,cbb60f43-967b-4338-a3df-4b8834f02906,36711903,4974,4973,1,39
250,cbb60f43-967b-4338-a3df-4b8834f02906,36711903,4974,4973,-1,39
250,cbb60f43-967b-4338-a3df-4b8834f02906,36711908,440,47,393,0
250,cbb60f43-967b-4338-a3df-4b8834f02906,36711908,473,445,28,1
250,cbb60f43-967b-4338-a3df-4b8834f02906,36711908,1128,492,636,10
250,cbb60f43-967b-4338-a3df-4b8834f02906,36711908,1669,1132,537,11
250,cbb60f43-967b-4338-a3df-4b8834f02906,36711908,2328,1714,614,27
250,cbb60f43-967b-4338-a3df-4b8834f02906,36711908,2857,2329,528,34
250,cbb60f43-967b-4338-a3df-4b8834f02906,36711908,3391,2886,505,48
250,cbb60f43-967b-4338-a3df-4b8834f02906,36711908,3402,3395,7,49
250,cbb60f43-967b-4338-a3df-4b8834f02906,36711908,3420,3404,16,52
250,cbb60f43-967b-4338-a3df-4b8834f02906,36711908,3750,3438,312,53
250,cbb60f43-967b-4338-a3df-4b8834f02906,36711908,3946,3776,170,55
250,cbb60f43-967b-4338-a3df-4b8834f02906,36711908,4037,3966,71,56
250,cbb60f43-967b-4338-a3df-4b8834f02906,36711908,4122,4046,76,57
250,cbb60f43-967b-4338-a3df-4b8834f02906,36711908,4122,4121,1,58
250,8aed27e2-aa97-4d19-a34c-9b43fac21109,36703721,783,22,761,0
250,8aed27e2-aa97-4d19-a34c-9b43fac21109,36703721,1521,841,680,7
250,8aed27e2-aa97-4d19-a34c-9b43fac21109,36703721,1523,1522,1,8
250,8aed27e2-aa97-4d19-a34c-9b43fac21109,36703721,1718,1525,193,9
250,8aed27e2-aa97-4d19-a34c-9b43fac21109,36703721,1729,1719,10,10
250,8aed27e2-aa97-4d19-a34c-9b43fac21109,36703721,2507,1731,776,28
250,8aed27e2-aa97-4d19-a34c-9b43fac21109,36703721,2636,2510,126,29
250,8aed27e2-aa97-4d19-a34c-9b43fac21109,36703721,2876,2662,214,30
250,8aed27e2-aa97-4d19-a34c-9b43fac21109,36703721,3125,2877,248,37
250,8aed27e2-aa97-4d19-a34c-9b43fac21109,36703721,3206,2916,-290,38
250,8aed27e2-aa97-4d19-a34c-9b43fac21109,36703721,2921,2915,6,39
250,8aed27e2-aa97-4d19-a34c-9b43fac21109,36703721,3249,2922,327,40
250,8aed27e2-aa97-4d19-a34c-9b43fac21109,36703721,3503,3260,243,41
250,8aed27e2-aa97-4d19-a34c-9b43fac21109,36703721,3620,3505,115,42
250,8aed27e2-aa97-4d19-a34c-9b43fac21109,36703721,3636,3636,0,43
250,8aed27e2-aa97-4d19-a34c-9b43fac21109,36703721,4234,3656,578,44
250,8aed27e2-aa97-4d19-a34c-9b43fac21109,36703721,5881,4293,1588,55
250,8aed27e2-aa97-4d19-a34c-9b43fac21109,36703721,6062,5901,161,56
250,8aed27e2-aa97-4d19-a34c-9b43fac21109,36703721,7207,6069,1138,57
250,8aed27e2-aa97-4d19-a34c-9b43fac21109,36703721,8387,7285,1102,58
250,8aed27e2-aa97-4d19-a34c-9b43fac21109,36716248,465,7,458,0
250,8aed27e2-aa97-4d19-a34c-9b43fac21109,36716248,466,466,0,1
250,8aed27e2-aa97-4d19-a34c-9b43fac21109,36716248,524,155,-369,4
250,8aed27e2-aa97-4d19-a34c-9b43fac21109,36716248,474,0,474,5
250,8aed27e2-aa97-4d19-a34c-9b43fac21109,36716248,699,497,202,6
250,8aed27e2-aa97-4d19-a34c-9b43fac21109,36716248,689,553,-136,9
250,8aed27e2-aa97-4d19-a34c-9b43fac21109,36716248,550,515,-35,10
250,8aed27e2-aa97-4d19-a34c-9b43fac21109,36716248,494,344,-150,11
250,8aed27e2-aa97-4d19-a34c-9b43fac21109,36716248,1151,348,803,13
250,8aed27e2-aa97-4d19-a34c-9b43fac21109,36716248,1398,1155,243,15
250,8aed27e2-aa97-4d19-a34c-9b43fac21109,36716248,1492,1415,77,16
250,8aed27e2-aa97-4d19-a34c-9b43fac21109,36716248,1566,1500,66,19
250,8aed27e2-aa97-4d19-a34c-9b43fac21109,36716248,1743,1596,147,20
250,8aed27e2-aa97-4d19-a34c-9b43fac21109,36716248,1930,1749,181,32
250,8aed27e2-aa97-4d19-a34c-9b43fac21109,36716248,1965,1932,33,33
250,8aed27e2-aa97-4d19-a34c-9b43fac21109,36716248,2284,2002,282,37
250,8aed27e2-aa97-4d19-a34c-9b43fac21109,36716248,2326,2288,38,38
250,8aed27e2-aa97-4d19-a34c-9b43fac21109,36716248,2600,2407,193,48
250,8aed27e2-aa97-4d19-a34c-9b43fac21109,36716248,2618,2605,13,49
250,8aed27e2-aa97-4d19-a34c-9b43fac21109,36716248,2918,2628,290,54
250,8aed27e2-aa97-4d19-a34c-9b43fac21109,36716248,2951,2926,25,55
250,8aed27e2-aa97-4d19-a34c-9b43fac21109,36716248,3288,2978,310,57
250,8aed27e2-aa97-4d19-a34c-9b43fac21109,36716248,3447,3299,148,58
250,8aed27e2-aa97-4d19-a34c-9b43fac21109,36716248,3622,3473,149,59
250,8aed27e2-aa97-4d19-a34c-9b43fac21109,36716248,3778,3632,146,61
250,8aed27e2-aa97-4d19-a34c-9b43fac21109,36716248,4536,3852,684,62
250,8aed27e2-aa97-4d19-a34c-9b43fac21109,36716248,5135,4550,585,64
250,8aed27e2-aa97-4d19-a34c-9b43fac21109,36716248,5331,5166,165,66
8,423bf1ac-1e57-4c57-acf9-d73c47b2559e,36708583,1963,8,1955,0
8,423bf1ac-1e57-4c57-acf9-d73c47b2559e,36708583,2940,1982,958,1
8,423bf1ac-1e57-4c57-acf9-d73c47b2559e,36708583,4559,2964,1595,2
8,423bf1ac-1e57-4c57-acf9-d73c47b2559e,36708583,5886,4605,1281,3
8,423bf1ac-1e57-4c57-acf9-d73c47b2559e,36708583,5881,5876,-5,6
8,423bf1ac-1e57-4c57-acf9-d73c47b2559e,36708583,5882,5877,5,7
8,423bf1ac-1e57-4c57-acf9-d73c47b2559e,36708583,5973,5898,75,32
8,423bf1ac-1e57-4c57-acf9-d73c47b2559e,36708583,6697,5975,722,33
8,423bf1ac-1e57-4c57-acf9-d73c47b2559e,36708583,6737,6704,33,34
250,405d0dc8-3494-4b2b-a840-e2720211084a,36721892,449,25,424,0
250,405d0dc8-3494-4b2b-a840-e2720211084a,36721892,762,450,312,4
250,405d0dc8-3494-4b2b-a840-e2720211084a,36721892,976,774,202,8
250,405d0dc8-3494-4b2b-a840-e2720211084a,36721892,1616,984,632,12
250,405d0dc8-3494-4b2b-a840-e2720211084a,36721892,2235,1653,582,16
250,405d0dc8-3494-4b2b-a840-e2720211084a,36721892,2216,654,-1562,26
250,405d0dc8-3494-4b2b-a840-e2720211084a,36721892,653,652,-1,27
250,405d0dc8-3494-4b2b-a840-e2720211084a,36721892,2139,686,1453,28
250,405d0dc8-3494-4b2b-a840-e2720211084a,36721892,2235,2163,72,29
250,405d0dc8-3494-4b2b-a840-e2720211084a,36721689,539,4,535,0
250,405d0dc8-3494-4b2b-a840-e2720211084a,36721689,1017,559,458,7
250,405d0dc8-3494-4b2b-a840-e2720211084a,36721689,1531,1034,497,8
250,405d0dc8-3494-4b2b-a840-e2720211084a,36721689,1594,1544,50,9
250,405d0dc8-3494-4b2b-a840-e2720211084a,36721689,2215,1598,617,10
250,405d0dc8-3494-4b2b-a840-e2720211084a,36721689,2766,2233,533,15
250,405d0dc8-3494-4b2b-a840-e2720211084a,36721689,3310,2783,527,16
250,405d0dc8-3494-4b2b-a840-e2720211084a,36721689,3598,3369,229,17
250,405d0dc8-3494-4b2b-a840-e2720211084a,36721689,5187,3625,1562,18
250,608ae910-d7a0-4d8f-8d32-1e6e0ba04688,36719561,238,1,237,0
250,608ae910-d7a0-4d8f-8d32-1e6e0ba04688,36719561,403,239,164,3
250,608ae910-d7a0-4d8f-8d32-1e6e0ba04688,36719561,557,424,133,4
250,608ae910-d7a0-4d8f-8d32-1e6e0ba04688,36719561,536,0,-536,8
260,2667fac6-1038-4547-b281-9fa41d6dd49f,36726880,1122,20,1102,0
260,2667fac6-1038-4547-b281-9fa41d6dd49f,36726880,1812,1136,676,1
261,f60b1224-8ec2-469f-818c-205edeb1f07c,36733209,179,3,176,0
261,f60b1224-8ec2-469f-818c-205edeb1f07c,36733209,704,183,521,1
261,f60b1224-8ec2-469f-818c-205edeb1f07c,36733209,1075,726,349,2
261,f60b1224-8ec2-469f-818c-205edeb1f07c,36733209,2084,1090,994,3
261,f60b1224-8ec2-469f-818c-205edeb1f07c,36733209,3541,2111,1430,4
261,f60b1224-8ec2-469f-818c-205edeb1f07c,36733209,3920,3557,363,5
261,f60b1224-8ec2-469f-818c-205edeb1f07c,36701515,1016,26,990,0
261,f60b1224-8ec2-469f-818c-205edeb1f07c,36701515,1718,1038,680,1
261,f60b1224-8ec2-469f-818c-205edeb1f07c,36701515,1721,0,-1721,2
250,64a43d8a-4b67-42b0-9f59-ac8a1bb1c684,36736571,502,20,482,0
250,64a43d8a-4b67-42b0-9f59-ac8a1bb1c684,36736571,754,513,241,1
250,64a43d8a-4b67-42b0-9f59-ac8a1bb1c684,36736571,732,37,-695,2
250,64a43d8a-4b67-42b0-9f59-ac8a1bb1c684,36736571,870,38,832,3
250,64a43d8a-4b67-42b0-9f59-ac8a1bb1c684,36736571,1392,872,520,4
250,64a43d8a-4b67-42b0-9f59-ac8a1bb1c684,36736571,1716,1413,303,5
250,64a43d8a-4b67-42b0-9f59-ac8a1bb1c684,36736571,2289,1732,557,6
250,64a43d8a-4b67-42b0-9f59-ac8a1bb1c684,36736571,3006,2298,708,7
250,64a43d8a-4b67-42b0-9f59-ac8a1bb1c684,36736571,3414,3010,404,8
261,009b8175-f1ca-4f76-be13-5673098f2d14,36736571,263,9,254,0
261,009b8175-f1ca-4f76-be13-5673098f2d14,36736571,890,274,616,1
261,009b8175-f1ca-4f76-be13-5673098f2d14,36736571,1440,931,509,2
261,009b8175-f1ca-4f76-be13-5673098f2d14,36736571,1155,856,-299,3
261,009b8175-f1ca-4f76-be13-5673098f2d14,36736571,2323,878,1445,14
261,009b8175-f1ca-4f76-be13-5673098f2d14,36736571,3166,2352,814,15
261,009b8175-f1ca-4f76-be13-5673098f2d14,36736571,4346,3248,1098,16
261,009b8175-f1ca-4f76-be13-5673098f2d14,36736571,6404,4465,1939,17
261,009b8175-f1ca-4f76-be13-5673098f2d14,36726095,348,22,326,0
261,009b8175-f1ca-4f76-be13-5673098f2d14,36726095,572,352,220,1
261,009b8175-f1ca-4f76-be13-5673098f2d14,36726095,1410,595,815,4
261,009b8175-f1ca-4f76-be13-5673098f2d14,36726095,1922,1462,460,5
261,009b8175-f1ca-4f76-be13-5673098f2d14,36726095,3251,1925,1326,6
261,009b8175-f1ca-4f76-be13-5673098f2d14,36726095,3528,3317,211,7
261,009b8175-f1ca-4f76-be13-5673098f2d14,36726095,3449,3449,0,8
261,009b8175-f1ca-4f76-be13-5673098f2d14,36726095,4084,3469,615,13
261,009b8175-f1ca-4f76-be13-5673098f2d14,36726095,4678,4122,556,14
261,009b8175-f1ca-4f76-be13-5673098f2d14,36726095,4725,4679,46,32
261,009b8175-f1ca-4f76-be13-5673098f2d14,36726095,5118,4751,367,34
261,009b8175-f1ca-4f76-be13-5673098f2d14,36726095,5559,5208,351,41
261,009b8175-f1ca-4f76-be13-5673098f2d14,36726095,6384,5578,806,44
261,009b8175-f1ca-4f76-be13-5673098f2d14,36726095,8824,6583,2241,45
261,009b8175-f1ca-4f76-be13-5673098f2d14,36723486,249,28,221,0
261,009b8175-f1ca-4f76-be13-5673098f2d14,36723486,964,264,700,1
261,009b8175-f1ca-4f76-be13-5673098f2d14,36723486,1851,1023,828,2
261,009b8175-f1ca-4f76-be13-5673098f2d14,36723486,2231,1858,373,3
261,009b8175-f1ca-4f76-be13-5673098f2d14,36723486,2269,2239,30,4
261,009b8175-f1ca-4f76-be13-5673098f2d14,36723486,2263,2224,-39,5
261,009b8175-f1ca-4f76-be13-5673098f2d14,36723486,2207,2141,-66,6
261,009b8175-f1ca-4f76-be13-5673098f2d14,36723486,2181,2150,31,7
261,009b8175-f1ca-4f76-be13-5673098f2d14,36723486,2348,2182,166,8
261,009b8175-f1ca-4f76-be13-5673098f2d14,36723486,2727,2349,378,9
261,009b8175-f1ca-4f76-be13-5673098f2d14,36723486,2816,2729,87,10
261,009b8175-f1ca-4f76-be13-5673098f2d14,36723486,2875,2818,57,11
261,009b8175-f1ca-4f76-be13-5673098f2d14,36723486,3375,2877,498,12
261,009b8175-f1ca-4f76-be13-5673098f2d14,36723486,3082,3046,36,13
261,009b8175-f1ca-4f76-be13-5673098f2d14,36723486,3092,3080,12,14
261,009b8175-f1ca-4f76-be13-5673098f2d14,36723486,3093,3093,0,15
261,009b8175-f1ca-4f76-be13-5673098f2d14,36723486,3129,3094,35,16
261,009b8175-f1ca-4f76-be13-5673098f2d14,36723486,3153,3130,23,18
261,009b8175-f1ca-4f76-be13-5673098f2d14,36723486,4048,3158,890,19
261,009b8175-f1ca-4f76-be13-5673098f2d14,36734377,510,19,491,0
261,009b8175-f1ca-4f76-be13-5673098f2d14,36734377,860,516,344,2
261,009b8175-f1ca-4f76-be13-5673098f2d14,36734377,846,237,-609,3
261,009b8175-f1ca-4f76-be13-5673098f2d14,36734377,29,10,19,15
261,009b8175-f1ca-4f76-be13-5673098f2d14,36734377,305,45,260,16
261,009b8175-f1ca-4f76-be13-5673098f2d14,36734377,689,318,371,17
261,009b8175-f1ca-4f76-be13-5673098f2d14,36734377,994,718,276,18
261,009b8175-f1ca-4f76-be13-5673098f2d14,36734377,1031,995,36,19
261,009b8175-f1ca-4f76-be13-5673098f2d14,36734377,1347,1038,309,22
261,009b8175-f1ca-4f76-be13-5673098f2d14,36734377,1368,1351,17,23
261,009b8175-f1ca-4f76-be13-5673098f2d14,36734377,1815,1373,442,33
261,009b8175-f1ca-4f76-be13-5673098f2d14,36734377,1758,1287,-471,38
261,009b8175-f1ca-4f76-be13-5673098f2d14,36734377,1263,1211,-52,39
261,009b8175-f1ca-4f76-be13-5673098f2d14,36734377,1586,1227,359,64
261,009b8175-f1ca-4f76-be13-5673098f2d14,36734377,1656,1601,55,65
261,009b8175-f1ca-4f76-be13-5673098f2d14,36734377,1918,1682,236,67
261,009b8175-f1ca-4f76-be13-5673098f2d14,36734377,2447,1943,504,77
261,009b8175-f1ca-4f76-be13-5673098f2d14,36734377,2573,2472,101,78
261,009b8175-f1ca-4f76-be13-5673098f2d14,36734377,3035,2609,426,82
261,009b8175-f1ca-4f76-be13-5673098f2d14,36734377,3211,3057,154,83
261,009b8175-f1ca-4f76-be13-5673098f2d14,36734377,3172,2820,-352,2004
261,009b8175-f1ca-4f76-be13-5673098f2d14,36734377,3138,0,-3138,2005
261,009b8175-f1ca-4f76-be13-5673098f2d14,36734377,4016,2,4014,2007
261,80515f53-d41c-4e14-b249-683adddc657c,36742640,50,0,-50,0
261,80515f53-d41c-4e14-b249-683adddc657c,36742640,407,2,405,12
261,80515f53-d41c-4e14-b249-683adddc657c,36742640,977,431,546,15
261,80515f53-d41c-4e14-b249-683adddc657c,36742640,1023,987,36,16
261,80515f53-d41c-4e14-b249-683adddc657c,36742640,1027,1027,0,17
261,80515f53-d41c-4e14-b249-683adddc657c,36742640,1368,1061,307,18
261,80515f53-d41c-4e14-b249-683adddc657c,36742640,1368,790,578,21
261,80515f53-d41c-4e14-b249-683adddc657c,36738049,313,27,286,0
261,80515f53-d41c-4e14-b249-683adddc657c,36738049,345,322,23,1
261,80515f53-d41c-4e14-b249-683adddc657c,36738049,844,352,492,12
261,80515f53-d41c-4e14-b249-683adddc657c,36738049,1210,872,338,19
261,80515f53-d41c-4e14-b249-683adddc657c,36738049,1698,1225,473,26
261,80515f53-d41c-4e14-b249-683adddc657c,36738049,2262,1721,541,29
261,80515f53-d41c-4e14-b249-683adddc657c,36738049,3100,2335,765,30
261,80515f53-d41c-4e14-b249-683adddc657c,36738049,3371,3102,269,54
261,80515f53-d41c-4e14-b249-683adddc657c,36738049,3372,3372,0,55
261,80515f53-d41c-4e14-b249-683adddc657c,36738049,3716,3377,339,58
261,80515f53-d41c-4e14-b249-683adddc657c,36738049,3716,3478,238,69
261,80515f53-d41c-4e14-b249-683adddc657c,36718347,504,16,488,0
261,80515f53-d41c-4e14-b249-683adddc657c,36718347,1082,527,555,4
261,80515f53-d41c-4e14-b249-683adddc657c,36718347,1442,1098,344,5
261,80515f53-d41c-4e14-b249-683adddc657c,36718347,1493,1455,38,6
261,80515f53-d41c-4e14-b249-683adddc657c,36718347,2321,1498,823,7
261,80515f53-d41c-4e14-b249-683adddc657c,36718347,3129,2357,772,8
261,80515f53-d41c-4e14-b249-683adddc657c,36718347,3502,3176,326,9
261,80515f53-d41c-4e14-b249-683adddc657c,36718347,3560,3515,45,10
261,80515f53-d41c-4e14-b249-683adddc657c,36718347,3968,3567,401,16
261,80515f53-d41c-4e14-b249-683adddc657c,36718347,3998,3977,21,17
261,80515f53-d41c-4e14-b249-683adddc657c,36718347,4246,4026,220,18
261,80515f53-d41c-4e14-b249-683adddc657c,36718347,4424,4259,165,25
261,80515f53-d41c-4e14-b249-683adddc657c,36732336,310,13,297,0
261,80515f53-d41c-4e14-b249-683adddc657c,36732336,315,312,3,1
261,80515f53-d41c-4e14-b249-683adddc657c,36732336,493,320,173,10
261,80515f53-d41c-4e14-b249-683adddc657c,36732336,622,513,109,11
261,80515f53-d41c-4e14-b249-683adddc657c,36732336,1719,644,1075,12
261,80515f53-d41c-4e14-b249-683adddc657c,36732336,2945,1776,1169,35
261,80515f53-d41c-4e14-b249-683adddc657c,36732336,3449,2981,468,36
261,80515f53-d41c-4e14-b249-683adddc657c,36732336,4764,3499,1265,37
261,80515f53-d41c-4e14-b249-683adddc657c,36732336,4754,4538,-216,40
261,80515f53-d41c-4e14-b249-683adddc657c,36724562,370,14,356,0
261,80515f53-d41c-4e14-b249-683adddc657c,36724562,718,379,339,9
261,80515f53-d41c-4e14-b249-683adddc657c,36724562,756,729,27,10
261,80515f53-d41c-4e14-b249-683adddc657c,36724562,1399,801,598,11
261,80515f53-d41c-4e14-b249-683adddc657c,36724562,1432,1407,25,12
261,80515f53-d41c-4e14-b249-683adddc657c,36724562,1524,1452,72,25
261,80515f53-d41c-4e14-b249-683adddc657c,36724562,1826,1556,270,26
261,80515f53-d41c-4e14-b249-683adddc657c,36724562,2054,1832,222,28
261,80515f53-d41c-4e14-b249-683adddc657c,36724562,2646,2069,577,29
261,80515f53-d41c-4e14-b249-683adddc657c,36724562,2685,2654,31,30
261,80515f53-d41c-4e14-b249-683adddc657c,36724562,3581,2703,878,35
261,80515f53-d41c-4e14-b249-683adddc657c,36724562,3566,3472,-94,37
261,80515f53-d41c-4e14-b249-683adddc657c,36724562,3504,3498,6,38
261,80515f53-d41c-4e14-b249-683adddc657c,36724562,4272,3519,753,59
261,80515f53-d41c-4e14-b249-683adddc657c,36724562,4285,4276,9,60
261,80515f53-d41c-4e14-b249-683adddc657c,36724562,4348,4296,52,65
261,80515f53-d41c-4e14-b249-683adddc657c,36724562,4304,2935,-1369,82
261,80515f53-d41c-4e14-b249-683adddc657c,36724562,4348,2951,1397,83
261,80515f53-d41c-4e14-b249-683adddc657c,36724562,4331,4133,-198,89
261,80515f53-d41c-4e14-b249-683adddc657c,36731596,586,24,562,0
261,80515f53-d41c-4e14-b249-683adddc657c,36731596,1012,626,386,1
261,80515f53-d41c-4e14-b249-683adddc657c,36731596,1593,1016,577,4
261,80515f53-d41c-4e14-b249-683adddc657c,36731596,2174,1610,564,7
261,80515f53-d41c-4e14-b249-683adddc657c,36731596,2559,2175,384,12
261,80515f53-d41c-4e14-b249-683adddc657c,36731596,3157,2603,554,13
261,80515f53-d41c-4e14-b249-683adddc657c,36731596,3500,3163,337,15
261,80515f53-d41c-4e14-b249-683adddc657c,36731596,3497,2995,-502,26
261,80515f53-d41c-4e14-b249-683adddc657c,36731596,2978,2876,-102,27
261,80515f53-d41c-4e14-b249-683adddc657c,36731596,2870,2637,-233,33
261,80515f53-d41c-4e14-b249-683adddc657c,36731596,2608,1232,-1376,35
261,80515f53-d41c-4e14-b249-683adddc657c,36731596,1164,0,-1164,36
261,20ddbde0-96ca-4340-9961-0640f3795f87,36746763,579,44,535,0
261,20ddbde0-96ca-4340-9961-0640f3795f87,36746763,1594,645,949,1
261,20ddbde0-96ca-4340-9961-0640f3795f87,36746763,5236,1638,3598,2
261,20ddbde0-96ca-4340-9961-0640f3795f87,36746094,117,8,109,0
261,20ddbde0-96ca-4340-9961-0640f3795f87,36746094,545,126,419,1
261,20ddbde0-96ca-4340-9961-0640f3795f87,36746094,802,549,253,2
261,20ddbde0-96ca-4340-9961-0640f3795f87,36746094,1103,834,269,3
261,20ddbde0-96ca-4340-9961-0640f3795f87,36746094,1477,1124,353,7
261,20ddbde0-96ca-4340-9961-0640f3795f87,36746094,1573,1480,93,10
261,20ddbde0-96ca-4340-9961-0640f3795f87,36746094,1750,1575,175,11
261,20ddbde0-96ca-4340-9961-0640f3795f87,36746094,1854,1759,95,15
261,20ddbde0-96ca-4340-9961-0640f3795f87,36746094,2040,1855,185,16
261,20ddbde0-96ca-4340-9961-0640f3795f87,36746094,2557,2074,483,18
261,20ddbde0-96ca-4340-9961-0640f3795f87,36746094,5217,2621,2596,19
261,20ddbde0-96ca-4340-9961-0640f3795f87,36746094,5784,5261,523,20
261,20ddbde0-96ca-4340-9961-0640f3795f87,36746094,6715,5846,869,33
261,20ddbde0-96ca-4340-9961-0640f3795f87,36746094,7442,6472,-970,34
261,20ddbde0-96ca-4340-9961-0640f3795f87,36746094,7031,6560,471,35
261,20ddbde0-96ca-4340-9961-0640f3795f87,36746094,6977,6441,-536,138
261,20ddbde0-96ca-4340-9961-0640f3795f87,36746094,6404,6091,-313,139
261,46b26fe9-956b-4b8c-b7cb-2c56fbaa4ce4,36744470,622,29,593,0
250,275b62cf-0d89-44d2-b479-12bcac4c8d09,36744925,60,1,59,0
250,275b62cf-0d89-44d2-b479-12bcac4c8d09,36744925,153,62,91,1
250,275b62cf-0d89-44d2-b479-12bcac4c8d09,36744925,190,154,36,2
250,275b62cf-0d89-44d2-b479-12bcac4c8d09,36744925,413,195,218,3
250,275b62cf-0d89-44d2-b479-12bcac4c8d09,36744925,745,424,321,11
250,275b62cf-0d89-44d2-b479-12bcac4c8d09,36744925,1436,748,688,14
250,275b62cf-0d89-44d2-b479-12bcac4c8d09,36744925,1473,1443,30,15
250,275b62cf-0d89-44d2-b479-12bcac4c8d09,36744925,1755,1477,278,19
250,275b62cf-0d89-44d2-b479-12bcac4c8d09,36744925,1783,1761,22,20
250,275b62cf-0d89-44d2-b479-12bcac4c8d09,36744925,2077,1794,283,28
250,275b62cf-0d89-44d2-b479-12bcac4c8d09,36744925,2120,2082,38,29
250,275b62cf-0d89-44d2-b479-12bcac4c8d09,36744925,2383,2123,260,35
250,275b62cf-0d89-44d2-b479-12bcac4c8d09,36744925,2404,2385,19,36
250,275b62cf-0d89-44d2-b479-12bcac4c8d09,36744925,2447,2408,39,43
250,275b62cf-0d89-44d2-b479-12bcac4c8d09,36744925,2849,2463,386,44
250,275b62cf-0d89-44d2-b479-12bcac4c8d09,36744925,3174,2851,323,45
250,275b62cf-0d89-44d2-b479-12bcac4c8d09,36744925,3156,2869,-287,56
250,275b62cf-0d89-44d2-b479-12bcac4c8d09,36744925,2867,2866,-1,57
250,275b62cf-0d89-44d2-b479-12bcac4c8d09,36744461,64,4,60,0
250,275b62cf-0d89-44d2-b479-12bcac4c8d09,36744461,296,86,210,1
250,275b62cf-0d89-44d2-b479-12bcac4c8d09,36744461,496,316,180,12
250,275b62cf-0d89-44d2-b479-12bcac4c8d09,36744461,647,522,125,13
250,275b62cf-0d89-44d2-b479-12bcac4c8d09,36744461,795,650,145,14
250,275b62cf-0d89-44d2-b479-12bcac4c8d09,36744461,1181,808,373,22
250,275b62cf-0d89-44d2-b479-12bcac4c8d09,36744461,1465,1182,283,30
250,275b62cf-0d89-44d2-b479-12bcac4c8d09,36744461,1570,1486,84,31
250,275b62cf-0d89-44d2-b479-12bcac4c8d09,36744461,1827,1576,251,36
261,945a3c8c-0d26-41d2-837a-95de47317190,36744925,219,12,207,0
261,945a3c8c-0d26-41d2-837a-95de47317190,36744925,678,222,456,1
261,945a3c8c-0d26-41d2-837a-95de47317190,36744925,1123,696,427,3
261,945a3c8c-0d26-41d2-837a-95de47317190,36744925,1674,1168,506,4
261,945a3c8c-0d26-41d2-837a-95de47317190,36744925,2280,1679,601,5
261,945a3c8c-0d26-41d2-837a-95de47317190,36744925,3009,2289,720,7
261,945a3c8c-0d26-41d2-837a-95de47317190,36744925,4396,3022,1374,8
250,f0dc25db-45d0-4305-9ef0-29cd85ea22ca,36744470,903,4,899,0
250,f0dc25db-45d0-4305-9ef0-29cd85ea22ca,36744470,957,912,45,1
250,f0dc25db-45d0-4305-9ef0-29cd85ea22ca,36744470,940,745,-195,5
250,f0dc25db-45d0-4305-9ef0-29cd85ea22ca,36744470,739,601,-138,6
250,f0dc25db-45d0-4305-9ef0-29cd85ea22ca,36744470,600,569,-31,7
250,f0dc25db-45d0-4305-9ef0-29cd85ea22ca,36744470,1082,584,498,10
250,f0dc25db-45d0-4305-9ef0-29cd85ea22ca,36744470,1109,1087,22,11
250,f0dc25db-45d0-4305-9ef0-29cd85ea22ca,36744470,1571,1119,452,12
250,f0dc25db-45d0-4305-9ef0-29cd85ea22ca,36744470,1601,1577,24,13
250,f0dc25db-45d0-4305-9ef0-29cd85ea22ca,36744470,1972,1605,367,14
250,f0dc25db-45d0-4305-9ef0-29cd85ea22ca,36744470,1974,1973,1,15
250,f0dc25db-45d0-4305-9ef0-29cd85ea22ca,36744470,2201,1975,226,17
250,f0dc25db-45d0-4305-9ef0-29cd85ea22ca,36744470,2470,2246,224,18
250,f0dc25db-45d0-4305-9ef0-29cd85ea22ca,36744470,2718,2475,243,19
250,f0dc25db-45d0-4305-9ef0-29cd85ea22ca,36744470,3051,2723,328,20
250,f0dc25db-45d0-4305-9ef0-29cd85ea22ca,36744470,3058,3054,4,21
250,f0dc25db-45d0-4305-9ef0-29cd85ea22ca,36744470,3450,3062,388,24
250,f0dc25db-45d0-4305-9ef0-29cd85ea22ca,36744470,3543,3459,84,25
250,f0dc25db-45d0-4305-9ef0-29cd85ea22ca,36744470,3542,3542,0,26
261,a7871fd5-6745-4fab-a6b5-e3726e4ecaa3,36754146,1150,6,1144,0
261,a7871fd5-6745-4fab-a6b5-e3726e4ecaa3,36754146,3032,1221,1811,1
261,a7871fd5-6745-4fab-a6b5-e3726e4ecaa3,36754146,3028,2032,-996,2
261,a7871fd5-6745-4fab-a6b5-e3726e4ecaa3,36754146,1873,0,-1873,3
261,a7871fd5-6745-4fab-a6b5-e3726e4ecaa3,36754009,151,21,130,0
261,a7871fd5-6745-4fab-a6b5-e3726e4ecaa3,36754009,221,159,62,1
261,a7871fd5-6745-4fab-a6b5-e3726e4ecaa3,36754009,253,222,31,2
261,a7871fd5-6745-4fab-a6b5-e3726e4ecaa3,36754009,299,254,45,3
261,a7871fd5-6745-4fab-a6b5-e3726e4ecaa3,36754009,372,300,72,4
261,a7871fd5-6745-4fab-a6b5-e3726e4ecaa3,36754009,491,374,117,5
261,a7871fd5-6745-4fab-a6b5-e3726e4ecaa3,36754009,762,521,241,6
261,a7871fd5-6745-4fab-a6b5-e3726e4ecaa3,36754009,824,772,52,7
261,a7871fd5-6745-4fab-a6b5-e3726e4ecaa3,36754009,1087,826,261,11
261,a7871fd5-6745-4fab-a6b5-e3726e4ecaa3,36754009,1139,1093,46,12
261,a7871fd5-6745-4fab-a6b5-e3726e4ecaa3,36754009,1228,1147,81,13
261,a7871fd5-6745-4fab-a6b5-e3726e4ecaa3,36754009,1367,1243,124,14
261,a7871fd5-6745-4fab-a6b5-e3726e4ecaa3,36754009,1461,1381,80,15
261,a7871fd5-6745-4fab-a6b5-e3726e4ecaa3,36754009,1781,1464,317,16
261,a7871fd5-6745-4fab-a6b5-e3726e4ecaa3,36754009,2070,1815,255,17
261,a7871fd5-6745-4fab-a6b5-e3726e4ecaa3,36754009,2100,2073,27,18
261,a7871fd5-6745-4fab-a6b5-e3726e4ecaa3,36754009,2100,2099,1,19
261,a7871fd5-6745-4fab-a6b5-e3726e4ecaa3,36754009,2099,2099,0,20
261,a7871fd5-6745-4fab-a6b5-e3726e4ecaa3,36754009,2100,2100,0,24
261,a7871fd5-6745-4fab-a6b5-e3726e4ecaa3,36754009,2053,1641,-412,26
250,43520516-39a9-449a-9c1c-71aaa91ad32f,36754229,66,2,64,0
250,43520516-39a9-449a-9c1c-71aaa91ad32f,36754229,66,0,66,4
250,43520516-39a9-449a-9c1c-71aaa91ad32f,36754229,39,0,-39,11
250,d08962da-27cc-45f8-a21e-c9fb8dcb8fcb,36756379,368,12,356,0
250,d08962da-27cc-45f8-a21e-c9fb8dcb8fcb,36756379,819,461,358,5
250,d08962da-27cc-45f8-a21e-c9fb8dcb8fcb,36756379,1179,823,356,6
250,d08962da-27cc-45f8-a21e-c9fb8dcb8fcb,36756379,1193,1180,13,7
250,d08962da-27cc-45f8-a21e-c9fb8dcb8fcb,36756379,1302,1197,105,8
250,d08962da-27cc-45f8-a21e-c9fb8dcb8fcb,36756379,1702,1304,398,13
250,d08962da-27cc-45f8-a21e-c9fb8dcb8fcb,36756379,1776,1713,63,14
250,f120f1a0-4ccc-4a44-9677-851b19723bda,36755495,523,18,505,0
250,f120f1a0-4ccc-4a44-9677-851b19723bda,36755495,447,115,-332,1
250,f120f1a0-4ccc-4a44-9677-851b19723bda,36755495,491,122,369,2
250,f120f1a0-4ccc-4a44-9677-851b19723bda,36755495,694,493,201,5
250,f120f1a0-4ccc-4a44-9677-851b19723bda,36755495,759,695,64,6
250,f120f1a0-4ccc-4a44-9677-851b19723bda,36755495,843,760,83,7
250,f120f1a0-4ccc-4a44-9677-851b19723bda,36755495,891,845,46,8
250,f120f1a0-4ccc-4a44-9677-851b19723bda,36755495,1183,900,283,14
250,f120f1a0-4ccc-4a44-9677-851b19723bda,36755495,1202,1185,17,15
250,f120f1a0-4ccc-4a44-9677-851b19723bda,36755495,1693,1206,487,21
250,f120f1a0-4ccc-4a44-9677-851b19723bda,36755495,1769,1694,75,22
250,f120f1a0-4ccc-4a44-9677-851b19723bda,36755495,2198,1787,411,23
250,f120f1a0-4ccc-4a44-9677-851b19723bda,36755495,2447,2217,230,25
250,f120f1a0-4ccc-4a44-9677-851b19723bda,36755495,5053,2497,2556,41
259,09e5dbaf-a4b7-4e60-8790-4f2125bf59e3,36757060,105,5,100,0
259,09e5dbaf-a4b7-4e60-8790-4f2125bf59e3,36757060,110,107,3,1
259,09e5dbaf-a4b7-4e60-8790-4f2125bf59e3,36757060,311,122,189,2
259,09e5dbaf-a4b7-4e60-8790-4f2125bf59e3,36757060,398,323,75,3
259,09e5dbaf-a4b7-4e60-8790-4f2125bf59e3,36757060,477,399,78,4
259,09e5dbaf-a4b7-4e60-8790-4f2125bf59e3,36757060,938,481,457,5
259,09e5dbaf-a4b7-4e60-8790-4f2125bf59e3,36757060,942,939,3,6
259,09e5dbaf-a4b7-4e60-8790-4f2125bf59e3,36757060,996,944,52,10
259,09e5dbaf-a4b7-4e60-8790-4f2125bf59e3,36757060,1128,997,131,11
259,09e5dbaf-a4b7-4e60-8790-4f2125bf59e3,36757060,1184,1133,51,12
259,09e5dbaf-a4b7-4e60-8790-4f2125bf59e3,36757060,1191,1184,7,13
259,09e5dbaf-a4b7-4e60-8790-4f2125bf59e3,36757060,1272,1192,80,15
259,09e5dbaf-a4b7-4e60-8790-4f2125bf59e3,36757060,1352,1278,74,16
259,09e5dbaf-a4b7-4e60-8790-4f2125bf59e3,36757060,1358,1355,3,17
259,09e5dbaf-a4b7-4e60-8790-4f2125bf59e3,36757060,1692,1394,298,25
259,09e5dbaf-a4b7-4e60-8790-4f2125bf59e3,36757060,1693,1692,-1,26
259,09e5dbaf-a4b7-4e60-8790-4f2125bf59e3,36757060,1846,1707,139,30
259,09e5dbaf-a4b7-4e60-8790-4f2125bf59e3,36757060,2477,1854,623,31
259,09e5dbaf-a4b7-4e60-8790-4f2125bf59e3,36757060,2498,2482,16,32
259,09e5dbaf-a4b7-4e60-8790-4f2125bf59e3,36757060,2687,2523,164,34
259,09e5dbaf-a4b7-4e60-8790-4f2125bf59e3,36757060,2921,2699,222,35
259,09e5dbaf-a4b7-4e60-8790-4f2125bf59e3,36757060,3318,2923,395,40
259,09e5dbaf-a4b7-4e60-8790-4f2125bf59e3,36757060,3318,3317,1,46
259,09e5dbaf-a4b7-4e60-8790-4f2125bf59e3,36756917,56,1,55,0
259,09e5dbaf-a4b7-4e60-8790-4f2125bf59e3,36756917,112,57,55,1
259,09e5dbaf-a4b7-4e60-8790-4f2125bf59e3,36756917,145,113,32,13
259,09e5dbaf-a4b7-4e60-8790-4f2125bf59e3,36756917,164,146,18,14
259,09e5dbaf-a4b7-4e60-8790-4f2125bf59e3,36756917,204,168,36,15
259,09e5dbaf-a4b7-4e60-8790-4f2125bf59e3,36756917,201,189,-12,16
259,09e5dbaf-a4b7-4e60-8790-4f2125bf59e3,36756917,251,199,52,17
259,09e5dbaf-a4b7-4e60-8790-4f2125bf59e3,36756917,265,253,12,18
259,09e5dbaf-a4b7-4e60-8790-4f2125bf59e3,36756917,482,266,216,19
259,09e5dbaf-a4b7-4e60-8790-4f2125bf59e3,36756917,484,483,-1,20
259,09e5dbaf-a4b7-4e60-8790-4f2125bf59e3,36756917,484,483,1,20
259,09e5dbaf-a4b7-4e60-8790-4f2125bf59e3,36756917,609,491,118,23
259,09e5dbaf-a4b7-4e60-8790-4f2125bf59e3,36756917,1104,623,481,26
259,09e5dbaf-a4b7-4e60-8790-4f2125bf59e3,36756917,1159,1106,53,27
259,09e5dbaf-a4b7-4e60-8790-4f2125bf59e3,36756917,2100,1174,926,34
259,09e5dbaf-a4b7-4e60-8790-4f2125bf59e3,36756917,2070,2058,-12,35
259,09e5dbaf-a4b7-4e60-8790-4f2125bf59e3,36756917,2078,2061,17,43
259,09e5dbaf-a4b7-4e60-8790-4f2125bf59e3,36756917,2100,2084,16,45
259,09e5dbaf-a4b7-4e60-8790-4f2125bf59e3,36756723,44,11,33,0
259,09e5dbaf-a4b7-4e60-8790-4f2125bf59e3,36756723,70,45,25,1
259,09e5dbaf-a4b7-4e60-8790-4f2125bf59e3,36756723,115,72,43,4
259,09e5dbaf-a4b7-4e60-8790-4f2125bf59e3,36756723,196,118,78,5
259,09e5dbaf-a4b7-4e60-8790-4f2125bf59e3,36756723,242,198,44,6
259,09e5dbaf-a4b7-4e60-8790-4f2125bf59e3,36756723,271,243,28,7
259,09e5dbaf-a4b7-4e60-8790-4f2125bf59e3,36756723,278,272,6,8
259,09e5dbaf-a4b7-4e60-8790-4f2125bf59e3,36756723,293,283,10,9
259,09e5dbaf-a4b7-4e60-8790-4f2125bf59e3,36756723,345,295,50,12
259,09e5dbaf-a4b7-4e60-8790-4f2125bf59e3,36756723,385,346,39,13
259,09e5dbaf-a4b7-4e60-8790-4f2125bf59e3,36756723,444,389,55,15
259,09e5dbaf-a4b7-4e60-8790-4f2125bf59e3,36756723,469,446,23,16
259,09e5dbaf-a4b7-4e60-8790-4f2125bf59e3,36756723,509,472,37,17
259,09e5dbaf-a4b7-4e60-8790-4f2125bf59e3,36756723,515,511,4,18
259,09e5dbaf-a4b7-4e60-8790-4f2125bf59e3,36756723,656,519,137,19
259,09e5dbaf-a4b7-4e60-8790-4f2125bf59e3,36756723,758,666,92,20
259,09e5dbaf-a4b7-4e60-8790-4f2125bf59e3,36756723,840,759,81,24
259,09e5dbaf-a4b7-4e60-8790-4f2125bf59e3,36756723,922,851,71,25
259,09e5dbaf-a4b7-4e60-8790-4f2125bf59e3,36756723,970,936,34,28
259,09e5dbaf-a4b7-4e60-8790-4f2125bf59e3,36756723,1210,984,226,29
259,09e5dbaf-a4b7-4e60-8790-4f2125bf59e3,36756723,1211,1211,0,30
259,09e5dbaf-a4b7-4e60-8790-4f2125bf59e3,36756723,1596,1223,373,33
259,09e5dbaf-a4b7-4e60-8790-4f2125bf59e3,36756848,36,1,35,0
259,09e5dbaf-a4b7-4e60-8790-4f2125bf59e3,36756848,40,37,3,1
259,09e5dbaf-a4b7-4e60-8790-4f2125bf59e3,36756848,120,41,79,6
259,09e5dbaf-a4b7-4e60-8790-4f2125bf59e3,36756848,587,121,466,7
259,09e5dbaf-a4b7-4e60-8790-4f2125bf59e3,36756848,608,591,17,8
259,09e5dbaf-a4b7-4e60-8790-4f2125bf59e3,36756848,687,610,77,12
259,09e5dbaf-a4b7-4e60-8790-4f2125bf59e3,36756848,698,698,0,13
259,09e5dbaf-a4b7-4e60-8790-4f2125bf59e3,36756848,696,644,-52,18
259,09e5dbaf-a4b7-4e60-8790-4f2125bf59e3,36756848,643,607,-36,19
259,09e5dbaf-a4b7-4e60-8790-4f2125bf59e3,36756848,606,602,-4,20
259,09e5dbaf-a4b7-4e60-8790-4f2125bf59e3,36756848,601,569,-32,22
259,09e5dbaf-a4b7-4e60-8790-4f2125bf59e3,36756848,601,569,32,22
259,09e5dbaf-a4b7-4e60-8790-4f2125bf59e3,36754206,464,6,458,0
259,09e5dbaf-a4b7-4e60-8790-4f2125bf59e3,36754206,984,487,497,1
259,09e5dbaf-a4b7-4e60-8790-4f2125bf59e3,36754206,1132,986,146,2
259,09e5dbaf-a4b7-4e60-8790-4f2125bf59e3,36754206,1717,1180,537,3
259,09e5dbaf-a4b7-4e60-8790-4f2125bf59e3,36754206,1968,1738,230,4
261,2a13ccc4-8935-4375-b340-d04f927884ad,36756917,545,27,518,0
261,2a13ccc4-8935-4375-b340-d04f927884ad,36756917,951,570,381,9
261,2a13ccc4-8935-4375-b340-d04f927884ad,36756917,1560,954,606,10
261,a5559b7c-f8b9-4232-bba1-5af2203097f8,36757456,615,8,607,0
261,a5559b7c-f8b9-4232-bba1-5af2203097f8,36757456,658,621,37,1
261,a5559b7c-f8b9-4232-bba1-5af2203097f8,36757456,1691,694,997,17
261,a5559b7c-f8b9-4232-bba1-5af2203097f8,36757456,2151,1696,455,18
261,a5559b7c-f8b9-4232-bba1-5af2203097f8,36757456,4265,2152,2113,19
261,a5559b7c-f8b9-4232-bba1-5af2203097f8,36757456,7030,4267,2763,20
261,a5559b7c-f8b9-4232-bba1-5af2203097f8,36757456,11466,7052,4414,21
261,a5559b7c-f8b9-4232-bba1-5af2203097f8,36757456,11523,11475,48,22
261,a5559b7c-f8b9-4232-bba1-5af2203097f8,36757456,12052,11572,480,26
261,a5559b7c-f8b9-4232-bba1-5af2203097f8,36757456,12041,6867,-5174,27
261,a5559b7c-f8b9-4232-bba1-5af2203097f8,36757456,6526,477,-6049,28
250,fe1408ac-5f84-4edd-9507-a42cd1d195d2,36756723,490,31,459,0
250,fe1408ac-5f84-4edd-9507-a42cd1d195d2,36756723,498,492,6,1
250,fe1408ac-5f84-4edd-9507-a42cd1d195d2,36756723,948,500,448,5
250,fe1408ac-5f84-4edd-9507-a42cd1d195d2,36756723,1566,962,604,9
250,fe1408ac-5f84-4edd-9507-a42cd1d195d2,36756723,2197,1580,617,10
250,fe1408ac-5f84-4edd-9507-a42cd1d195d2,36756723,2394,2202,192,11
127,900ccc86-0b34-44f1-8f2f-055ac12879fd,36744470,6,6,0,0
127,900ccc86-0b34-44f1-8f2f-055ac12879fd,36744470,295,32,263,1
127,900ccc86-0b34-44f1-8f2f-055ac12879fd,36744470,248,0,-248,3
127,900ccc86-0b34-44f1-8f2f-055ac12879fd,36744470,307,8,299,4
127,900ccc86-0b34-44f1-8f2f-055ac12879fd,36744470,679,317,362,5
127,900ccc86-0b34-44f1-8f2f-055ac12879fd,36744470,845,683,162,9
127,900ccc86-0b34-44f1-8f2f-055ac12879fd,36744470,849,847,2,10
127,900ccc86-0b34-44f1-8f2f-055ac12879fd,36744470,1164,854,310,18
127,900ccc86-0b34-44f1-8f2f-055ac12879fd,36744470,1557,1170,387,28
127,900ccc86-0b34-44f1-8f2f-055ac12879fd,36744470,1632,1568,64,29
127,900ccc86-0b34-44f1-8f2f-055ac12879fd,36744470,1663,1636,27,41
127,900ccc86-0b34-44f1-8f2f-055ac12879fd,36744470,1852,1676,176,42
127,900ccc86-0b34-44f1-8f2f-055ac12879fd,36744470,2108,1859,249,48
127,900ccc86-0b34-44f1-8f2f-055ac12879fd,36744470,2110,2109,1,49
127,900ccc86-0b34-44f1-8f2f-055ac12879fd,36744470,2137,2112,25,55
127,900ccc86-0b34-44f1-8f2f-055ac12879fd,36744470,2421,2150,271,56
127,900ccc86-0b34-44f1-8f2f-055ac12879fd,36744470,2473,2434,39,57
127,900ccc86-0b34-44f1-8f2f-055ac12879fd,36744470,2402,2040,-362,13070
127,900ccc86-0b34-44f1-8f2f-055ac12879fd,36744470,2046,2043,3,13071
250,c6e2a333-5be3-49ea-ad71-4d6d7650c361,36760859,302,10,292,0
250,c6e2a333-5be3-49ea-ad71-4d6d7650c361,36760859,725,381,344,1
250,c6e2a333-5be3-49ea-ad71-4d6d7650c361,36760859,794,733,61,13
250,c6e2a333-5be3-49ea-ad71-4d6d7650c361,36760859,970,798,172,14
250,c6e2a333-5be3-49ea-ad71-4d6d7650c361,36760859,1200,983,217,15
250,c6e2a333-5be3-49ea-ad71-4d6d7650c361,36760859,1602,1214,388,16
250,c6e2a333-5be3-49ea-ad71-4d6d7650c361,36760859,1621,1606,15,17
250,c6e2a333-5be3-49ea-ad71-4d6d7650c361,36760859,1818,1627,191,18
250,c6e2a333-5be3-49ea-ad71-4d6d7650c361,36760859,2126,1823,303,19
250,c6e2a333-5be3-49ea-ad71-4d6d7650c361,36760859,2834,2158,676,20
250,c6e2a333-5be3-49ea-ad71-4d6d7650c361,36760859,3114,2846,268,31
250,c6e2a333-5be3-49ea-ad71-4d6d7650c361,36760859,3108,2791,-317,36
250,e44e63dc-0d52-4745-a017-2523312d33b7,36763208,507,28,479,0
250,e44e63dc-0d52-4745-a017-2523312d33b7,36763208,1284,532,752,1
250,e44e63dc-0d52-4745-a017-2523312d33b7,36763208,1590,1300,290,2
250,e44e63dc-0d52-4745-a017-2523312d33b7,36763208,1590,1589,1,3
250,53b355d8-e501-47c2-a5b9-3aa72922386a,36763208,236,8,228,0
250,53b355d8-e501-47c2-a5b9-3aa72922386a,36763208,382,245,137,1
250,53b355d8-e501-47c2-a5b9-3aa72922386a,36763208,1092,442,650,12
250,53b355d8-e501-47c2-a5b9-3aa72922386a,36763208,1149,1107,42,13
250,53b355d8-e501-47c2-a5b9-3aa72922386a,36763208,1493,1157,336,27
250,53b355d8-e501-47c2-a5b9-3aa72922386a,36763208,1499,1496,3,28
250,53b355d8-e501-47c2-a5b9-3aa72922386a,36763208,1999,1514,485,32
250,53b355d8-e501-47c2-a5b9-3aa72922386a,36763208,2368,2004,364,47
250,53b355d8-e501-47c2-a5b9-3aa72922386a,36763208,2747,2390,357,64
250,53b355d8-e501-47c2-a5b9-3aa72922386a,36763208,2808,2808,0,77
250,53b355d8-e501-47c2-a5b9-3aa72922386a,36763208,2795,2542,-253,93
250,53b355d8-e501-47c2-a5b9-3aa72922386a,36763208,2522,2120,-402,106
261,4539e2e3-90e9-419b-acd1-1597fbe4f42d,36763572,40,8,32,0
261,4539e2e3-90e9-419b-acd1-1597fbe4f42d,36763572,283,52,231,4
261,4539e2e3-90e9-419b-acd1-1597fbe4f42d,36763572,287,284,3,5
261,4539e2e3-90e9-419b-acd1-1597fbe4f42d,36763572,630,317,313,6
261,4539e2e3-90e9-419b-acd1-1597fbe4f42d,36763572,793,632,161,7
261,4539e2e3-90e9-419b-acd1-1597fbe4f42d,36763572,1269,801,468,8
261,4539e2e3-90e9-419b-acd1-1597fbe4f42d,36763572,199,44,155,24
261,4539e2e3-90e9-419b-acd1-1597fbe4f42d,36763572,720,0,720,25
261,4539e2e3-90e9-419b-acd1-1597fbe4f42d,36763572,1076,724,352,26
261,4539e2e3-90e9-419b-acd1-1597fbe4f42d,36763572,1505,1084,421,27
261,4539e2e3-90e9-419b-acd1-1597fbe4f42d,36763572,2078,1536,542,28
261,4539e2e3-90e9-419b-acd1-1597fbe4f42d,36763572,2106,2087,19,29
261,4539e2e3-90e9-419b-acd1-1597fbe4f42d,36763572,2390,2132,258,38
261,4539e2e3-90e9-419b-acd1-1597fbe4f42d,36763572,2811,2397,414,39
261,4539e2e3-90e9-419b-acd1-1597fbe4f42d,36763572,2844,2812,32,40
261,4539e2e3-90e9-419b-acd1-1597fbe4f42d,36763572,3117,2866,251,43
261,4539e2e3-90e9-419b-acd1-1597fbe4f42d,36763572,4072,3182,890,44
261,4539e2e3-90e9-419b-acd1-1597fbe4f42d,36763572,4072,4071,1,46
261,4539e2e3-90e9-419b-acd1-1597fbe4f42d,36761497,180,1,179,0
261,4539e2e3-90e9-419b-acd1-1597fbe4f42d,36761497,193,181,12,1
261,4539e2e3-90e9-419b-acd1-1597fbe4f42d,36761497,219,194,25,2
261,4539e2e3-90e9-419b-acd1-1597fbe4f42d,36761497,254,220,34,3
261,4539e2e3-90e9-419b-acd1-1597fbe4f42d,36761497,466,255,211,4
261,4539e2e3-90e9-419b-acd1-1597fbe4f42d,36761497,782,480,302,5
261,4539e2e3-90e9-419b-acd1-1597fbe4f42d,36761497,945,784,161,6
261,4539e2e3-90e9-419b-acd1-1597fbe4f42d,36761497,1253,948,305,7
261,4539e2e3-90e9-419b-acd1-1597fbe4f42d,36761497,1403,1254,149,8
261,4539e2e3-90e9-419b-acd1-1597fbe4f42d,36761497,2164,1404,760,9
261,4539e2e3-90e9-419b-acd1-1597fbe4f42d,36761497,2196,2171,25,10
261,4539e2e3-90e9-419b-acd1-1597fbe4f42d,36761497,2350,2217,133,11
261,4539e2e3-90e9-419b-acd1-1597fbe4f42d,36761497,2687,2395,292,15
261,4539e2e3-90e9-419b-acd1-1597fbe4f42d,36761497,3374,2702,672,18
261,4539e2e3-90e9-419b-acd1-1597fbe4f42d,36761497,3896,3388,508,19
261,4539e2e3-90e9-419b-acd1-1597fbe4f42d,36761497,3854,0,-3854,21
261,4539e2e3-90e9-419b-acd1-1597fbe4f42d,36760985,172,18,154,0
261,4539e2e3-90e9-419b-acd1-1597fbe4f42d,36760985,171,0,-171,1
261,4539e2e3-90e9-419b-acd1-1597fbe4f42d,36763932,659,13,646,0
261,4539e2e3-90e9-419b-acd1-1597fbe4f42d,36763932,660,660,0,1
261,4539e2e3-90e9-419b-acd1-1597fbe4f42d,36763932,933,665,268,6
261,4539e2e3-90e9-419b-acd1-1597fbe4f42d,36763932,1141,936,205,7
261,4539e2e3-90e9-419b-acd1-1597fbe4f42d,36763932,1547,1162,385,13
261,4539e2e3-90e9-419b-acd1-1597fbe4f42d,36763932,1799,1579,220,18
261,4539e2e3-90e9-419b-acd1-1597fbe4f42d,36763932,2081,1841,240,19
261,4539e2e3-90e9-419b-acd1-1597fbe4f42d,36763932,2120,2089,31,20
261,4539e2e3-90e9-419b-acd1-1597fbe4f42d,36763932,2340,2155,185,21
261,4539e2e3-90e9-419b-acd1-1597fbe4f42d,36763932,2904,2355,549,27
261,4539e2e3-90e9-419b-acd1-1597fbe4f42d,36763932,2896,2806,-90,28
261,4539e2e3-90e9-419b-acd1-1597fbe4f42d,36763932,3518,2921,597,29
261,4539e2e3-90e9-419b-acd1-1597fbe4f42d,36763932,3554,3526,28,30
261,4539e2e3-90e9-419b-acd1-1597fbe4f42d,36763932,4628,3582,1046,31
261,4539e2e3-90e9-419b-acd1-1597fbe4f42d,36765143,230,18,212,0
261,4539e2e3-90e9-419b-acd1-1597fbe4f42d,36765143,388,233,155,1
261,4539e2e3-90e9-419b-acd1-1597fbe4f42d,36765143,957,389,568,2
261,4539e2e3-90e9-419b-acd1-1597fbe4f42d,36765143,1729,980,749,7
261,4539e2e3-90e9-419b-acd1-1597fbe4f42d,36765143,1905,1750,155,8
261,4539e2e3-90e9-419b-acd1-1597fbe4f42d,36765143,2061,1914,147,9
261,4539e2e3-90e9-419b-acd1-1597fbe4f42d,36765143,4024,2104,1920,15
261,4539e2e3-90e9-419b-acd1-1597fbe4f42d,36765143,4157,3119,-1038,16
261,4539e2e3-90e9-419b-acd1-1597fbe4f42d,36765143,3421,3227,194,17
261,4539e2e3-90e9-419b-acd1-1597fbe4f42d,36765143,3647,3431,216,18
261,4539e2e3-90e9-419b-acd1-1597fbe4f42d,36765143,3837,3670,167,22
261,4539e2e3-90e9-419b-acd1-1597fbe4f42d,36765143,5580,3916,1664,23
261,4539e2e3-90e9-419b-acd1-1597fbe4f42d,36765143,5580,5579,1,24
261,4539e2e3-90e9-419b-acd1-1597fbe4f42d,36744925,5,5,0,0
261,4539e2e3-90e9-419b-acd1-1597fbe4f42d,36744925,240,24,216,1
261,4539e2e3-90e9-419b-acd1-1597fbe4f42d,36744925,994,242,752,2
261,4539e2e3-90e9-419b-acd1-1597fbe4f42d,36744925,1521,1030,491,3
261,4539e2e3-90e9-419b-acd1-1597fbe4f42d,36744925,2304,1545,759,4
261,4539e2e3-90e9-419b-acd1-1597fbe4f42d,36744925,3780,2308,1472,5
261,4539e2e3-90e9-419b-acd1-1597fbe4f42d,36744925,4396,3840,556,6
259,172369d8-618e-4041-b974-232fcd2965db,36770136,43,8,35,0
259,172369d8-618e-4041-b974-232fcd2965db,36770136,80,45,35,1
259,172369d8-618e-4041-b974-232fcd2965db,36770136,95,82,13,5
259,172369d8-618e-4041-b974-232fcd2965db,36770136,622,96,526,6
261,567e9e71-dd2d-4321-87e2-84f0e8d19b69,36763902,684,20,664,0
261,567e9e71-dd2d-4321-87e2-84f0e8d19b69,36763902,701,686,15,1
261,567e9e71-dd2d-4321-87e2-84f0e8d19b69,36763902,1350,710,640,4
261,567e9e71-dd2d-4321-87e2-84f0e8d19b69,36763902,1351,1351,0,5
261,567e9e71-dd2d-4321-87e2-84f0e8d19b69,36763902,1739,1371,368,8
261,567e9e71-dd2d-4321-87e2-84f0e8d19b69,36763902,1862,1760,102,9
261,567e9e71-dd2d-4321-87e2-84f0e8d19b69,36763902,2225,1898,327,16
261,567e9e71-dd2d-4321-87e2-84f0e8d19b69,36763902,2503,2232,271,21
261,567e9e71-dd2d-4321-87e2-84f0e8d19b69,36763902,2651,2496,155,22
261,567e9e71-dd2d-4321-87e2-84f0e8d19b69,36763902,2650,2641,-9,23
261,567e9e71-dd2d-4321-87e2-84f0e8d19b69,36763902,3123,2645,478,40
261,567e9e71-dd2d-4321-87e2-84f0e8d19b69,36763902,3554,3153,401,47
261,567e9e71-dd2d-4321-87e2-84f0e8d19b69,36763902,4050,3575,475,48
261,567e9e71-dd2d-4321-87e2-84f0e8d19b69,36763902,4907,4101,806,49
250,b8ffc2af-977e-41ed-b09c-88d32bad01b1,36771749,363,59,304,0
250,b8ffc2af-977e-41ed-b09c-88d32bad01b1,36771749,476,397,79,1
250,b8ffc2af-977e-41ed-b09c-88d32bad01b1,36771749,523,479,44,8
250,b8ffc2af-977e-41ed-b09c-88d32bad01b1,36771749,702,541,161,9
250,b8ffc2af-977e-41ed-b09c-88d32bad01b1,36771749,1030,706,324,12
250,b8ffc2af-977e-41ed-b09c-88d32bad01b1,36771749,1336,1041,295,20
250,b8ffc2af-977e-41ed-b09c-88d32bad01b1,36771749,1432,1363,69,21
250,b8ffc2af-977e-41ed-b09c-88d32bad01b1,36771749,1721,1439,282,25
250,b8ffc2af-977e-41ed-b09c-88d32bad01b1,36771749,2042,1735,307,30
250,b8ffc2af-977e-41ed-b09c-88d32bad01b1,36771749,2057,2047,-10,31
250,b8ffc2af-977e-41ed-b09c-88d32bad01b1,36771749,2567,2151,416,39
250,b8ffc2af-977e-41ed-b09c-88d32bad01b1,36771749,2980,2628,352,41
250,b8ffc2af-977e-41ed-b09c-88d32bad01b1,36771749,3292,3013,279,42
250,b8ffc2af-977e-41ed-b09c-88d32bad01b1,36771749,3789,3316,473,49
250,b8ffc2af-977e-41ed-b09c-88d32bad01b1,36771749,4012,3792,220,56
250,b8ffc2af-977e-41ed-b09c-88d32bad01b1,36771749,4133,4035,98,57
250,b8ffc2af-977e-41ed-b09c-88d32bad01b1,36771749,4601,4150,451,63
250,b8ffc2af-977e-41ed-b09c-88d32bad01b1,36771749,4993,4606,387,64
250,b8ffc2af-977e-41ed-b09c-88d32bad01b1,36771749,5373,5051,322,65
250,b8ffc2af-977e-41ed-b09c-88d32bad01b1,36771749,6820,5393,1427,66
250,b8ffc2af-977e-41ed-b09c-88d32bad01b1,36771749,7161,6826,335,67
250,b8ffc2af-977e-41ed-b09c-88d32bad01b1,36771749,7139,6755,-384,68
250,b8ffc2af-977e-41ed-b09c-88d32bad01b1,36771749,6731,6436,-295,69
250,b8ffc2af-977e-41ed-b09c-88d32bad01b1,36771749,7161,6483,678,70
261,d94f1c8f-5ea6-4b04-8b52-253dcc0ae65c,36777494,377,25,352,0
261,d94f1c8f-5ea6-4b04-8b52-253dcc0ae65c,36777494,396,396,0,2
261,d94f1c8f-5ea6-4b04-8b52-253dcc0ae65c,36777494,1036,995,41,3
261,d94f1c8f-5ea6-4b04-8b52-253dcc0ae65c,36777494,1825,1039,786,12
261,d94f1c8f-5ea6-4b04-8b52-253dcc0ae65c,36777494,2185,1829,356,13
261,d94f1c8f-5ea6-4b04-8b52-253dcc0ae65c,36777494,3475,2233,1242,14
261,d94f1c8f-5ea6-4b04-8b52-253dcc0ae65c,36777494,3830,3481,349,15
261,d94f1c8f-5ea6-4b04-8b52-253dcc0ae65c,36777494,4164,3876,288,16
261,d94f1c8f-5ea6-4b04-8b52-253dcc0ae65c,36777494,4145,3387,-758,17
261,d94f1c8f-5ea6-4b04-8b52-253dcc0ae65c,36777494,3369,3273,-96,18
261,d94f1c8f-5ea6-4b04-8b52-253dcc0ae65c,36776167,1788,31,1757,0
261,d94f1c8f-5ea6-4b04-8b52-253dcc0ae65c,36776167,2636,1870,766,1
261,d94f1c8f-5ea6-4b04-8b52-253dcc0ae65c,36776167,4011,2641,1370,3
261,d94f1c8f-5ea6-4b04-8b52-253dcc0ae65c,36776167,5004,4039,965,4
261,d94f1c8f-5ea6-4b04-8b52-253dcc0ae65c,36776167,6488,5033,1455,5
261,d94f1c8f-5ea6-4b04-8b52-253dcc0ae65c,36776167,6980,1195,-5785,6
261,d94f1c8f-5ea6-4b04-8b52-253dcc0ae65c,36776167,988,0,-988,7
261,d94f1c8f-5ea6-4b04-8b52-253dcc0ae65c,36776167,258,192,66,8
261,d94f1c8f-5ea6-4b04-8b52-253dcc0ae65c,36776167,256,256,0,10
261,d94f1c8f-5ea6-4b04-8b52-253dcc0ae65c,36776167,264,247,17,11
261,d94f1c8f-5ea6-4b04-8b52-253dcc0ae65c,36776167,283,254,-29,12
261,d94f1c8f-5ea6-4b04-8b52-253dcc0ae65c,36776167,319,256,63,13
261,d94f1c8f-5ea6-4b04-8b52-253dcc0ae65c,36776167,323,239,-84,14
261,d94f1c8f-5ea6-4b04-8b52-253dcc0ae65c,36776167,235,107,-128,15
250,ee44ab94-02eb-4911-b09d-e54ba737f8b0,36780610,285,21,264,0
250,ee44ab94-02eb-4911-b09d-e54ba737f8b0,36780610,354,287,67,1
250,ee44ab94-02eb-4911-b09d-e54ba737f8b0,36780610,693,361,332,2
250,ee44ab94-02eb-4911-b09d-e54ba737f8b0,36780610,826,701,125,3
250,ee44ab94-02eb-4911-b09d-e54ba737f8b0,36780610,889,829,60,4
250,ee44ab94-02eb-4911-b09d-e54ba737f8b0,36780610,1084,903,181,5
250,ee44ab94-02eb-4911-b09d-e54ba737f8b0,36780610,1530,1088,442,9
250,ee44ab94-02eb-4911-b09d-e54ba737f8b0,36780610,1532,1532,0,10
250,ee44ab94-02eb-4911-b09d-e54ba737f8b0,36780610,1713,1533,180,11
250,ee44ab94-02eb-4911-b09d-e54ba737f8b0,36780610,1723,1718,5,12
250,ee44ab94-02eb-4911-b09d-e54ba737f8b0,36780610,2099,1729,370,13
250,ee44ab94-02eb-4911-b09d-e54ba737f8b0,36780610,2103,2103,0,15
250,ee44ab94-02eb-4911-b09d-e54ba737f8b0,36780610,2430,2124,306,16
250,ee44ab94-02eb-4911-b09d-e54ba737f8b0,36780610,2438,2438,0,24
250,ee44ab94-02eb-4911-b09d-e54ba737f8b0,36780610,2574,2467,107,25
250,ee44ab94-02eb-4911-b09d-e54ba737f8b0,36780610,2574,2573,1,46
250,ee44ab94-02eb-4911-b09d-e54ba737f8b0,36779901,585,2,583,0
250,ee44ab94-02eb-4911-b09d-e54ba737f8b0,36779901,869,607,262,13
250,ee44ab94-02eb-4911-b09d-e54ba737f8b0,36779901,1080,870,210,14
250,ee44ab94-02eb-4911-b09d-e54ba737f8b0,36779901,1380,1090,290,15
250,ee44ab94-02eb-4911-b09d-e54ba737f8b0,36779901,1500,1384,116,17
250,ee44ab94-02eb-4911-b09d-e54ba737f8b0,36779901,1582,1501,81,21
250,ee44ab94-02eb-4911-b09d-e54ba737f8b0,36779901,1656,1589,67,22
250,ee44ab94-02eb-4911-b09d-e54ba737f8b0,36756107,731,56,675,0
250,ee44ab94-02eb-4911-b09d-e54ba737f8b0,36756107,1115,733,382,4
250,ee44ab94-02eb-4911-b09d-e54ba737f8b0,36756107,1487,1137,350,12
250,ee44ab94-02eb-4911-b09d-e54ba737f8b0,36756107,2122,1492,630,13
250,ee44ab94-02eb-4911-b09d-e54ba737f8b0,36756107,2692,2124,568,14
250,ee44ab94-02eb-4911-b09d-e54ba737f8b0,36756107,2718,2698,20,15
250,ee44ab94-02eb-4911-b09d-e54ba737f8b0,36756107,3041,2720,321,17
250,ee44ab94-02eb-4911-b09d-e54ba737f8b0,36756107,3615,3071,544,18
250,ee44ab94-02eb-4911-b09d-e54ba737f8b0,36763902,523,11,512,0
250,ee44ab94-02eb-4911-b09d-e54ba737f8b0,36763902,785,544,241,1
250,ee44ab94-02eb-4911-b09d-e54ba737f8b0,36763902,1144,792,352,29
250,ee44ab94-02eb-4911-b09d-e54ba737f8b0,36763902,1170,1150,20,30
250,ee44ab94-02eb-4911-b09d-e54ba737f8b0,36763902,1932,1227,705,39
250,ee44ab94-02eb-4911-b09d-e54ba737f8b0,36763902,1947,1933,14,40
250,ee44ab94-02eb-4911-b09d-e54ba737f8b0,36763902,1925,1772,-153,41
250,ee44ab94-02eb-4911-b09d-e54ba737f8b0,36763902,1771,1771,0,42
250,ee44ab94-02eb-4911-b09d-e54ba737f8b0,36763902,1884,1773,111,43
250,ee44ab94-02eb-4911-b09d-e54ba737f8b0,36763902,1882,1873,-9,44
250,ee44ab94-02eb-4911-b09d-e54ba737f8b0,36763902,2397,1892,505,47
250,ee44ab94-02eb-4911-b09d-e54ba737f8b0,36763902,2408,2402,6,51
250,ee44ab94-02eb-4911-b09d-e54ba737f8b0,36763902,2812,2419,393,52
250,ee44ab94-02eb-4911-b09d-e54ba737f8b0,36763902,3162,2825,337,63
250,ee44ab94-02eb-4911-b09d-e54ba737f8b0,36763902,3469,3167,302,64
250,ee44ab94-02eb-4911-b09d-e54ba737f8b0,36763902,4571,3476,1095,79
250,ee44ab94-02eb-4911-b09d-e54ba737f8b0,36763902,4695,4575,120,92
250,ee44ab94-02eb-4911-b09d-e54ba737f8b0,36763902,4781,4701,80,93
250,ee44ab94-02eb-4911-b09d-e54ba737f8b0,36763902,4788,4782,6,94
261,f8cccb74-12d4-49c8-9e7c-7f24092ce84d,36775437,162,4,158,0
261,f8cccb74-12d4-49c8-9e7c-7f24092ce84d,36775437,412,166,246,1
261,f8cccb74-12d4-49c8-9e7c-7f24092ce84d,36775437,1161,421,740,2
261,f8cccb74-12d4-49c8-9e7c-7f24092ce84d,36775437,1609,1194,415,3
261,f8cccb74-12d4-49c8-9e7c-7f24092ce84d,36775437,3777,1700,2077,4
261,f8cccb74-12d4-49c8-9e7c-7f24092ce84d,36775437,5389,3781,1608,5
261,f8cccb74-12d4-49c8-9e7c-7f24092ce84d,36775437,5828,5453,375,6
261,f8cccb74-12d4-49c8-9e7c-7f24092ce84d,36780610,561,62,499,0
261,f8cccb74-12d4-49c8-9e7c-7f24092ce84d,36780610,1100,582,518,1
261,f8cccb74-12d4-49c8-9e7c-7f24092ce84d,36780610,1520,1101,419,2
261,f8cccb74-12d4-49c8-9e7c-7f24092ce84d,36780610,1572,1522,50,3
261,f8cccb74-12d4-49c8-9e7c-7f24092ce84d,36780610,1657,1587,70,4
261,f8cccb74-12d4-49c8-9e7c-7f24092ce84d,36780610,1606,1476,-130,5
261,f8cccb74-12d4-49c8-9e7c-7f24092ce84d,36780610,1512,1487,25,6
261,f8cccb74-12d4-49c8-9e7c-7f24092ce84d,36780610,2050,1514,536,7
261,f8cccb74-12d4-49c8-9e7c-7f24092ce84d,36780610,3596,1653,-1943,8
261,f8cccb74-12d4-49c8-9e7c-7f24092ce84d,36780610,1510,0,-1510,9
261,f8cccb74-12d4-49c8-9e7c-7f24092ce84d,36776114,404,24,380,0
261,f8cccb74-12d4-49c8-9e7c-7f24092ce84d,36776114,442,405,37,1
261,f8cccb74-12d4-49c8-9e7c-7f24092ce84d,36776114,726,449,277,2
261,f8cccb74-12d4-49c8-9e7c-7f24092ce84d,36776114,1259,743,516,3
261,f8cccb74-12d4-49c8-9e7c-7f24092ce84d,36776114,1376,1263,113,4
261,eff94206-4432-4709-bf66-e627d5380fa5,36772253,222,7,215,0
261,eff94206-4432-4709-bf66-e627d5380fa5,36772253,512,227,285,1
261,eff94206-4432-4709-bf66-e627d5380fa5,36772253,829,522,307,12
261,eff94206-4432-4709-bf66-e627d5380fa5,36772253,1241,831,410,13
261,eff94206-4432-4709-bf66-e627d5380fa5,36772253,1303,1250,53,26
261,eff94206-4432-4709-bf66-e627d5380fa5,36772253,1570,1311,259,27
261,eff94206-4432-4709-bf66-e627d5380fa5,36772253,1988,1617,371,53
261,eff94206-4432-4709-bf66-e627d5380fa5,36772253,2297,2002,295,54
261,eff94206-4432-4709-bf66-e627d5380fa5,36772253,2367,2308,59,55
261,eff94206-4432-4709-bf66-e627d5380fa5,36772253,2716,2386,330,56
261,eff94206-4432-4709-bf66-e627d5380fa5,36772253,2666,807,-1859,74
261,eff94206-4432-4709-bf66-e627d5380fa5,36772253,650,0,-650,75
261,eff94206-4432-4709-bf66-e627d5380fa5,36772253,273,13,260,76
261,eff94206-4432-4709-bf66-e627d5380fa5,36772253,167,0,-167,77
250,5d068e98-43c8-4ff9-8026-9221f89e4a26,36778350,521,13,508,0
250,5d068e98-43c8-4ff9-8026-9221f89e4a26,36778350,1954,528,1426,2
250,5d068e98-43c8-4ff9-8026-9221f89e4a26,36778350,2527,347,-2180,3
250,5d068e98-43c8-4ff9-8026-9221f89e4a26,36778350,892,349,543,8
250,5d068e98-43c8-4ff9-8026-9221f89e4a26,36778350,1063,911,152,9
250,5d068e98-43c8-4ff9-8026-9221f89e4a26,36781770,494,26,468,0
250,5d068e98-43c8-4ff9-8026-9221f89e4a26,36781770,507,498,9,1
250,5d068e98-43c8-4ff9-8026-9221f89e4a26,36781770,922,528,394,4
250,5d068e98-43c8-4ff9-8026-9221f89e4a26,36781770,1094,931,163,9
250,5d068e98-43c8-4ff9-8026-9221f89e4a26,36781770,1407,1100,307,10
250,5d068e98-43c8-4ff9-8026-9221f89e4a26,36781770,1628,1410,218,14
250,5d068e98-43c8-4ff9-8026-9221f89e4a26,36781770,1975,1703,272,15
250,5d068e98-43c8-4ff9-8026-9221f89e4a26,36781770,2011,1982,29,18
250,5d068e98-43c8-4ff9-8026-9221f89e4a26,36781770,2435,2027,408,19
250,5d068e98-43c8-4ff9-8026-9221f89e4a26,36781770,2912,2442,470,21
250,5d068e98-43c8-4ff9-8026-9221f89e4a26,36781770,3117,2913,204,22
250,5d068e98-43c8-4ff9-8026-9221f89e4a26,36781770,3170,3120,50,23
250,5d068e98-43c8-4ff9-8026-9221f89e4a26,36781770,3423,3178,245,24
250,5d068e98-43c8-4ff9-8026-9221f89e4a26,36780715,524,13,511,0
250,5d068e98-43c8-4ff9-8026-9221f89e4a26,36780715,982,527,455,1
250,5d068e98-43c8-4ff9-8026-9221f89e4a26,36780715,1425,1042,383,2
250,5d068e98-43c8-4ff9-8026-9221f89e4a26,36780715,1882,1464,418,5
250,5d068e98-43c8-4ff9-8026-9221f89e4a26,36780715,1891,1884,7,6
250,5d068e98-43c8-4ff9-8026-9221f89e4a26,36780715,8315,1911,6404,11
250,5d068e98-43c8-4ff9-8026-9221f89e4a26,36780715,10917,8603,2314,12
250,25e0ef2f-e5e6-4370-b7dd-5e2f4d38114a,36789972,364,25,339,0
250,25e0ef2f-e5e6-4370-b7dd-5e2f4d38114a,36789972,806,381,425,1
250,25e0ef2f-e5e6-4370-b7dd-5e2f4d38114a,36789972,1363,833,530,2
250,25e0ef2f-e5e6-4370-b7dd-5e2f4d38114a,36789972,1434,1375,59,3
250,25e0ef2f-e5e6-4370-b7dd-5e2f4d38114a,36789972,2000,1451,549,5
250,25e0ef2f-e5e6-4370-b7dd-5e2f4d38114a,36789972,2239,2003,236,9
250,25e0ef2f-e5e6-4370-b7dd-5e2f4d38114a,36789972,2443,2266,177,10
250,25e0ef2f-e5e6-4370-b7dd-5e2f4d38114a,36789972,2486,2458,28,17
250,25e0ef2f-e5e6-4370-b7dd-5e2f4d38114a,36789972,2696,2517,179,18
250,25e0ef2f-e5e6-4370-b7dd-5e2f4d38114a,36789972,3095,2704,391,24
250,25e0ef2f-e5e6-4370-b7dd-5e2f4d38114a,36789972,3610,3112,498,81
250,25e0ef2f-e5e6-4370-b7dd-5e2f4d38114a,36789972,3559,3024,-535,84
250,25e0ef2f-e5e6-4370-b7dd-5e2f4d38114a,36789972,2950,2424,-526,85
250,25e0ef2f-e5e6-4370-b7dd-5e2f4d38114a,36789972,2418,2057,-361,86
250,25e0ef2f-e5e6-4370-b7dd-5e2f4d38114a,36789972,2043,1885,-158,87
250,25e0ef2f-e5e6-4370-b7dd-5e2f4d38114a,36789972,2322,1846,476,88
250,25e0ef2f-e5e6-4370-b7dd-5e2f4d38114a,36789972,2757,2327,430,89
250,25e0ef2f-e5e6-4370-b7dd-5e2f4d38114a,36789972,3295,2763,532,90
250,25e0ef2f-e5e6-4370-b7dd-5e2f4d38114a,36789972,3303,3299,4,91
250,25e0ef2f-e5e6-4370-b7dd-5e2f4d38114a,36789972,3937,3325,612,99
250,25e0ef2f-e5e6-4370-b7dd-5e2f4d38114a,36789972,4014,3941,73,115
250,25e0ef2f-e5e6-4370-b7dd-5e2f4d38114a,36789972,4026,4016,10,116
250,25e0ef2f-e5e6-4370-b7dd-5e2f4d38114a,36789972,4656,4083,573,127
250,25e0ef2f-e5e6-4370-b7dd-5e2f4d38114a,36789972,4866,4663,203,128
250,25e0ef2f-e5e6-4370-b7dd-5e2f4d38114a,36786481,138,3,135,0
250,25e0ef2f-e5e6-4370-b7dd-5e2f4d38114a,36786481,192,143,49,1
250,25e0ef2f-e5e6-4370-b7dd-5e2f4d38114a,36786481,1038,217,821,2
250,25e0ef2f-e5e6-4370-b7dd-5e2f4d38114a,36786481,1120,1051,69,3
250,25e0ef2f-e5e6-4370-b7dd-5e2f4d38114a,36786481,1433,1145,288,12
261,2e5fd721-9cf8-4512-a918-ee43dcd01a9f,36790956,356,39,317,0
261,2e5fd721-9cf8-4512-a918-ee43dcd01a9f,36790956,781,393,388,1
261,2e5fd721-9cf8-4512-a918-ee43dcd01a9f,36790956,1139,794,345,2
261,2e5fd721-9cf8-4512-a918-ee43dcd01a9f,36790956,1484,1183,301,3
261,2e5fd721-9cf8-4512-a918-ee43dcd01a9f,36790956,1682,1490,192,5
261,2e5fd721-9cf8-4512-a918-ee43dcd01a9f,36790956,2107,1686,421,6
261,2e5fd721-9cf8-4512-a918-ee43dcd01a9f,36790956,4183,2202,1981,7
261,2e5fd721-9cf8-4512-a918-ee43dcd01a9f,36790956,4227,3263,-964,8
261,2e5fd721-9cf8-4512-a918-ee43dcd01a9f,36790956,3250,2475,-775,12
261,2e5fd721-9cf8-4512-a918-ee43dcd01a9f,36774751,188,26,162,0
261,2e5fd721-9cf8-4512-a918-ee43dcd01a9f,36774751,216,190,26,1
261,2e5fd721-9cf8-4512-a918-ee43dcd01a9f,36774751,220,217,3,2
261,2e5fd721-9cf8-4512-a918-ee43dcd01a9f,36774751,222,221,1,3
261,2e5fd721-9cf8-4512-a918-ee43dcd01a9f,36772303,197,28,169,0
261,2e5fd721-9cf8-4512-a918-ee43dcd01a9f,36772303,201,198,3,1
261,2e5fd721-9cf8-4512-a918-ee43dcd01a9f,36772303,319,203,116,2
261,2e5fd721-9cf8-4512-a918-ee43dcd01a9f,36772303,358,321,37,3
261,2e5fd721-9cf8-4512-a918-ee43dcd01a9f,36772303,457,360,97,4
261,2e5fd721-9cf8-4512-a918-ee43dcd01a9f,36772303,618,477,141,5
261,2e5fd721-9cf8-4512-a918-ee43dcd01a9f,36772303,687,619,68,6
261,2e5fd721-9cf8-4512-a918-ee43dcd01a9f,36772303,911,691,220,7
261,2e5fd721-9cf8-4512-a918-ee43dcd01a9f,36772303,957,912,45,8
261,2e5fd721-9cf8-4512-a918-ee43dcd01a9f,36772303,967,958,9,9
261,2e5fd721-9cf8-4512-a918-ee43dcd01a9f,36772303,1579,992,587,11
261,2e5fd721-9cf8-4512-a918-ee43dcd01a9f,36772303,1712,1598,114,12
261,2e5fd721-9cf8-4512-a918-ee43dcd01a9f,36772303,2321,1729,592,13
261,2e5fd721-9cf8-4512-a918-ee43dcd01a9f,36772303,2418,0,-2418,14
261,2e5fd721-9cf8-4512-a918-ee43dcd01a9f,36772303,2791,82,2709,15
261,2e5fd721-9cf8-4512-a918-ee43dcd01a9f,36772303,2858,2792,66,16
261,2e5fd721-9cf8-4512-a918-ee43dcd01a9f,36772303,3128,2860,268,19
261,2e5fd721-9cf8-4512-a918-ee43dcd01a9f,36772303,3783,3144,639,20
261,2e5fd721-9cf8-4512-a918-ee43dcd01a9f,36772303,4199,3822,377,21
261,2e5fd721-9cf8-4512-a918-ee43dcd01a9f,36772303,4760,4222,538,22
261,2e5fd721-9cf8-4512-a918-ee43dcd01a9f,36772303,4980,4779,201,23
261,2e5fd721-9cf8-4512-a918-ee43dcd01a9f,36785883,971,1,970,0
261,2e5fd721-9cf8-4512-a918-ee43dcd01a9f,36785883,4419,980,3439,1
261,2e5fd721-9cf8-4512-a918-ee43dcd01a9f,36785883,4560,0,-4560,2
261,2e5fd721-9cf8-4512-a918-ee43dcd01a9f,36767373,70,14,56,0
261,2e5fd721-9cf8-4512-a918-ee43dcd01a9f,36767373,149,72,77,1
261,2e5fd721-9cf8-4512-a918-ee43dcd01a9f,36767373,307,173,134,4
261,2e5fd721-9cf8-4512-a918-ee43dcd01a9f,36767373,458,322,136,5
261,2e5fd721-9cf8-4512-a918-ee43dcd01a9f,36767373,667,488,179,7
261,2e5fd721-9cf8-4512-a918-ee43dcd01a9f,36767373,739,683,56,8
261,2e5fd721-9cf8-4512-a918-ee43dcd01a9f,36767373,907,741,166,9
261,2e5fd721-9cf8-4512-a918-ee43dcd01a9f,36767373,1014,917,97,10
261,2e5fd721-9cf8-4512-a918-ee43dcd01a9f,36767373,1149,1024,125,11
261,2e5fd721-9cf8-4512-a918-ee43dcd01a9f,36767373,1542,1150,392,23
261,2e5fd721-9cf8-4512-a918-ee43dcd01a9f,36767373,1826,1560,266,24
261,2e5fd721-9cf8-4512-a918-ee43dcd01a9f,36767373,2043,1830,213,32
261,2e5fd721-9cf8-4512-a918-ee43dcd01a9f,36767373,2105,2056,49,35
261,2e5fd721-9cf8-4512-a918-ee43dcd01a9f,36767373,2246,2117,129,36
261,2e5fd721-9cf8-4512-a918-ee43dcd01a9f,36767373,2272,2272,0,60
261,2e5fd721-9cf8-4512-a918-ee43dcd01a9f,36767373,2451,2289,162,61
261,2e5fd721-9cf8-4512-a918-ee43dcd01a9f,36767373,3002,2477,525,70
261,2e5fd721-9cf8-4512-a918-ee43dcd01a9f,36767373,3039,3009,30,71
261,2e5fd721-9cf8-4512-a918-ee43dcd01a9f,36767373,3126,3055,71,72
261,2e5fd721-9cf8-4512-a918-ee43dcd01a9f,36767373,3210,3144,66,73
261,2e5fd721-9cf8-4512-a918-ee43dcd01a9f,36767373,3372,3227,145,77
261,2e5fd721-9cf8-4512-a918-ee43dcd01a9f,36767373,3573,3390,183,82
261,2e5fd721-9cf8-4512-a918-ee43dcd01a9f,36767373,3716,3580,136,88
261,2e5fd721-9cf8-4512-a918-ee43dcd01a9f,36767373,3942,3742,200,89
261,2e5fd721-9cf8-4512-a918-ee43dcd01a9f,36767373,4089,3971,118,91
261,2e5fd721-9cf8-4512-a918-ee43dcd01a9f,36767373,4120,4096,24,92
261,2e5fd721-9cf8-4512-a918-ee43dcd01a9f,36767373,4240,4129,111,96
261,2e5fd721-9cf8-4512-a918-ee43dcd01a9f,36767373,4240,3786,454,106
261,2e5fd721-9cf8-4512-a918-ee43dcd01a9f,36767373,4234,1589,-2645,107
261,2e5fd721-9cf8-4512-a918-ee43dcd01a9f,36767373,1419,0,-1419,108
259,a13d8dca-062c-41af-9193-69e1dc1d7ae3,36794888,267,1,266,0
259,a13d8dca-062c-41af-9193-69e1dc1d7ae3,36794888,287,272,15,1
259,a13d8dca-062c-41af-9193-69e1dc1d7ae3,36794888,720,308,412,6
259,a13d8dca-062c-41af-9193-69e1dc1d7ae3,36794888,720,720,0,7
259,a13d8dca-062c-41af-9193-69e1dc1d7ae3,36794430,263,26,237,0
259,a13d8dca-062c-41af-9193-69e1dc1d7ae3,36794430,270,265,5,1
259,a13d8dca-062c-41af-9193-69e1dc1d7ae3,36794430,271,271,0,6
259,a13d8dca-062c-41af-9193-69e1dc1d7ae3,36794430,332,279,53,7
259,a13d8dca-062c-41af-9193-69e1dc1d7ae3,36794430,321,304,-17,8
259,a13d8dca-062c-41af-9193-69e1dc1d7ae3,36794430,303,239,-64,9
259,a13d8dca-062c-41af-9193-69e1dc1d7ae3,36794430,547,291,256,10
259,a13d8dca-062c-41af-9193-69e1dc1d7ae3,36794430,933,593,340,48
259,a13d8dca-062c-41af-9193-69e1dc1d7ae3,36794430,1029,940,89,49
259,a13d8dca-062c-41af-9193-69e1dc1d7ae3,36794430,1044,1029,15,50
259,a13d8dca-062c-41af-9193-69e1dc1d7ae3,36794430,1076,1047,29,51
259,a13d8dca-062c-41af-9193-69e1dc1d7ae3,36794430,1076,1065,-11,52
259,a13d8dca-062c-41af-9193-69e1dc1d7ae3,36794430,1076,1068,8,53
259,a13d8dca-062c-41af-9193-69e1dc1d7ae3,36794430,1076,1034,-42,54
259,a13d8dca-062c-41af-9193-69e1dc1d7ae3,36794430,1076,1034,42,54
261,dfbf9df2-393c-4eb9-9842-5fe178d0187f,36800730,460,34,426,0
261,dfbf9df2-393c-4eb9-9842-5fe178d0187f,36800730,1091,467,624,1
261,dfbf9df2-393c-4eb9-9842-5fe178d0187f,36800730,1637,1092,545,2
261,dfbf9df2-393c-4eb9-9842-5fe178d0187f,36800730,1643,1640,3,3
261,dfbf9df2-393c-4eb9-9842-5fe178d0187f,36800730,2128,1648,480,5
261,dfbf9df2-393c-4eb9-9842-5fe178d0187f,36800730,2388,2147,241,6
261,dfbf9df2-393c-4eb9-9842-5fe178d0187f,36800730,2760,2412,348,7
261,dfbf9df2-393c-4eb9-9842-5fe178d0187f,36800730,3392,2784,608,17
261,dfbf9df2-393c-4eb9-9842-5fe178d0187f,36800730,3592,3454,138,18
261,dfbf9df2-393c-4eb9-9842-5fe178d0187f,36800730,3590,3361,-229,19
251,3653c212-215b-441f-96b4-c49b0f5d0302,36802646,19,5,14,0
251,3653c212-215b-441f-96b4-c49b0f5d0302,36802646,255,40,215,1
251,3653c212-215b-441f-96b4-c49b0f5d0302,36802646,404,266,138,3
251,3653c212-215b-441f-96b4-c49b0f5d0302,36802646,473,410,63,4
251,3653c212-215b-441f-96b4-c49b0f5d0302,36802646,600,482,118,6
251,3653c212-215b-441f-96b4-c49b0f5d0302,36802646,1216,604,612,7
251,3653c212-215b-441f-96b4-c49b0f5d0302,36802646,1302,1229,73,8
251,3653c212-215b-441f-96b4-c49b0f5d0302,36802646,2052,1327,725,12
251,3653c212-215b-441f-96b4-c49b0f5d0302,36802646,1892,0,-1892,28
262,0a5c90d0-e6fc-49f6-a470-669f25b957f5,36804363,599,1,598,0
262,0a5c90d0-e6fc-49f6-a470-669f25b957f5,36804363,921,0,-921,1
262,0a5c90d0-e6fc-49f6-a470-669f25b957f5,36804363,49,7,42,2
262,0a5c90d0-e6fc-49f6-a470-669f25b957f5,36804363,4180,145,4035,3
262,0a5c90d0-e6fc-49f6-a470-669f25b957f5,36804363,4135,886,-3249,4
262,0a5c90d0-e6fc-49f6-a470-669f25b957f5,36804363,639,0,-639,5
262,0a5c90d0-e6fc-49f6-a470-669f25b957f5,36804245,3923,110,3813,0
262,0a5c90d0-e6fc-49f6-a470-669f25b957f5,36804245,4960,4083,877,1
262,0a5c90d0-e6fc-49f6-a470-669f25b957f5,36804245,4757,0,-4757,2
262,0a5c90d0-e6fc-49f6-a470-669f25b957f5,36801346,1200,31,1169,0
262,0a5c90d0-e6fc-49f6-a470-669f25b957f5,36801346,1201,0,-1201,1
262,0a5c90d0-e6fc-49f6-a470-669f25b957f5,36805657,354,76,278,0
262,0a5c90d0-e6fc-49f6-a470-669f25b957f5,36805657,1335,451,884,1
126,ebbd7953-1298-4b1f-b3cb-cf5ece5d7816,36809083,150,4,146,0
126,ebbd7953-1298-4b1f-b3cb-cf5ece5d7816,36809083,416,155,261,1
126,ebbd7953-1298-4b1f-b3cb-cf5ece5d7816,36809083,419,417,2,2
126,ebbd7953-1298-4b1f-b3cb-cf5ece5d7816,36809083,555,420,135,5
126,ebbd7953-1298-4b1f-b3cb-cf5ece5d7816,36809083,822,557,265,6
126,ebbd7953-1298-4b1f-b3cb-cf5ece5d7816,36809083,925,823,102,7
126,ebbd7953-1298-4b1f-b3cb-cf5ece5d7816,36809083,945,926,19,8
126,ebbd7953-1298-4b1f-b3cb-cf5ece5d7816,36809083,1103,956,147,15
126,ebbd7953-1298-4b1f-b3cb-cf5ece5d7816,36809083,1316,1109,207,16
126,ebbd7953-1298-4b1f-b3cb-cf5ece5d7816,36809083,1545,1326,219,18
126,ebbd7953-1298-4b1f-b3cb-cf5ece5d7816,36809083,1695,1549,146,19
126,ebbd7953-1298-4b1f-b3cb-cf5ece5d7816,36809083,1772,1699,73,20
126,ebbd7953-1298-4b1f-b3cb-cf5ece5d7816,36809083,1812,1775,37,21
126,ebbd7953-1298-4b1f-b3cb-cf5ece5d7816,36809083,1811,1807,-4,27
126,ebbd7953-1298-4b1f-b3cb-cf5ece5d7816,36809083,1812,1805,7,30
126,ebbd7953-1298-4b1f-b3cb-cf5ece5d7816,36809083,1811,1666,-145,31
126,ebbd7953-1298-4b1f-b3cb-cf5ece5d7816,36809083,1665,0,-1665,32
261,bc5f815c-a15a-46f8-92f1-650ca069a3fe,36809570,572,6,566,0
261,bc5f815c-a15a-46f8-92f1-650ca069a3fe,36809570,682,580,102,1
261,bc5f815c-a15a-46f8-92f1-650ca069a3fe,36809570,696,696,0,4
261,bc5f815c-a15a-46f8-92f1-650ca069a3fe,36809570,997,730,267,5
261,bc5f815c-a15a-46f8-92f1-650ca069a3fe,36809570,1204,1009,195,10
261,bc5f815c-a15a-46f8-92f1-650ca069a3fe,36809570,1717,1214,503,11
261,bc5f815c-a15a-46f8-92f1-650ca069a3fe,36809570,2398,1746,652,12
261,bc5f815c-a15a-46f8-92f1-650ca069a3fe,36809570,3353,2463,890,13
261,bc5f815c-a15a-46f8-92f1-650ca069a3fe,36809570,5646,3357,2289,14
261,bc5f815c-a15a-46f8-92f1-650ca069a3fe,36809570,7592,5648,1944,15
261,bc5f815c-a15a-46f8-92f1-650ca069a3fe,36809570,9595,7599,1996,16
261,bc5f815c-a15a-46f8-92f1-650ca069a3fe,36809570,9604,6384,-3220,17
261,bc5f815c-a15a-46f8-92f1-650ca069a3fe,36809570,6310,0,-6310,18
261,858ff2d9-4b66-44ec-8b27-614bc832d176,36819182,229,6,223,0
261,858ff2d9-4b66-44ec-8b27-614bc832d176,36819182,889,251,638,7
261,858ff2d9-4b66-44ec-8b27-614bc832d176,36819182,1124,913,211,8
261,858ff2d9-4b66-44ec-8b27-614bc832d176,36819182,1546,1136,410,14
261,858ff2d9-4b66-44ec-8b27-614bc832d176,36819182,1724,1563,161,15
261,858ff2d9-4b66-44ec-8b27-614bc832d176,36819182,0,0,0,19
261,858ff2d9-4b66-44ec-8b27-614bc832d176,36819182,565,7,558,21
261,858ff2d9-4b66-44ec-8b27-614bc832d176,36819182,568,567,1,22
261,858ff2d9-4b66-44ec-8b27-614bc832d176,36819182,902,575,327,23
261,858ff2d9-4b66-44ec-8b27-614bc832d176,36819182,1069,930,139,24
261,858ff2d9-4b66-44ec-8b27-614bc832d176,36819182,1223,1071,152,31
261,858ff2d9-4b66-44ec-8b27-614bc832d176,36819182,1434,1255,179,32
261,858ff2d9-4b66-44ec-8b27-614bc832d176,36819182,1611,1445,166,39
261,858ff2d9-4b66-44ec-8b27-614bc832d176,36819182,1774,1645,129,40
261,858ff2d9-4b66-44ec-8b27-614bc832d176,36819182,2198,1785,413,42
261,858ff2d9-4b66-44ec-8b27-614bc832d176,36819182,2208,2202,6,43
261,858ff2d9-4b66-44ec-8b27-614bc832d176,36819182,2427,2227,200,48
261,858ff2d9-4b66-44ec-8b27-614bc832d176,36819182,2561,2429,132,49
261,858ff2d9-4b66-44ec-8b27-614bc832d176,36819182,3290,2629,661,57
261,858ff2d9-4b66-44ec-8b27-614bc832d176,36819182,3358,3306,52,58
261,858ff2d9-4b66-44ec-8b27-614bc832d176,36819182,3322,2956,-366,59
261,858ff2d9-4b66-44ec-8b27-614bc832d176,36819182,2930,2377,-553,60
261,858ff2d9-4b66-44ec-8b27-614bc832d176,36818384,379,25,354,0
261,858ff2d9-4b66-44ec-8b27-614bc832d176,36818384,495,392,103,1
261,858ff2d9-4b66-44ec-8b27-614bc832d176,36818384,756,508,248,8
261,858ff2d9-4b66-44ec-8b27-614bc832d176,36818384,780,759,21,11
261,858ff2d9-4b66-44ec-8b27-614bc832d176,36818384,1092,821,271,12
261,858ff2d9-4b66-44ec-8b27-614bc832d176,36818384,1196,1093,103,13
261,858ff2d9-4b66-44ec-8b27-614bc832d176,36818384,1231,1196,35,14
261,858ff2d9-4b66-44ec-8b27-614bc832d176,36818384,1252,1232,20,15
261,858ff2d9-4b66-44ec-8b27-614bc832d176,36818384,1292,1253,39,16
261,858ff2d9-4b66-44ec-8b27-614bc832d176,36818384,1547,1294,253,17
261,858ff2d9-4b66-44ec-8b27-614bc832d176,36818384,1788,1557,231,28
261,858ff2d9-4b66-44ec-8b27-614bc832d176,36818384,2081,1814,267,32
261,858ff2d9-4b66-44ec-8b27-614bc832d176,36818384,2331,2094,237,36
261,858ff2d9-4b66-44ec-8b27-614bc832d176,36818384,2962,2341,621,42
261,858ff2d9-4b66-44ec-8b27-614bc832d176,36818384,2954,2499,-455,48
261,858ff2d9-4b66-44ec-8b27-614bc832d176,36818384,2498,2496,-2,49
261,858ff2d9-4b66-44ec-8b27-614bc832d176,36818055,429,36,393,0
261,858ff2d9-4b66-44ec-8b27-614bc832d176,36818055,770,442,328,1
261,858ff2d9-4b66-44ec-8b27-614bc832d176,36818055,962,774,188,6
261,858ff2d9-4b66-44ec-8b27-614bc832d176,36818055,947,109,-838,14
261,858ff2d9-4b66-44ec-8b27-614bc832d176,36818055,102,96,-6,15
261,858ff2d9-4b66-44ec-8b27-614bc832d176,36793052,188,1,187,0
261,858ff2d9-4b66-44ec-8b27-614bc832d176,36793052,814,195,619,1
261,858ff2d9-4b66-44ec-8b27-614bc832d176,36793052,978,829,149,17
261,858ff2d9-4b66-44ec-8b27-614bc832d176,36793052,1417,979,438,18
261,858ff2d9-4b66-44ec-8b27-614bc832d176,36793052,1639,1463,176,22
261,858ff2d9-4b66-44ec-8b27-614bc832d176,36793052,2358,1652,706,23
261,858ff2d9-4b66-44ec-8b27-614bc832d176,36793052,2733,2420,313,33
261,858ff2d9-4b66-44ec-8b27-614bc832d176,36793052,2985,2745,240,39
261,858ff2d9-4b66-44ec-8b27-614bc832d176,36793052,2986,2986,0,40
261,858ff2d9-4b66-44ec-8b27-614bc832d176,36793052,3072,2998,74,43
261,858ff2d9-4b66-44ec-8b27-614bc832d176,36793052,3099,3073,26,44
261,858ff2d9-4b66-44ec-8b27-614bc832d176,36793052,3101,3101,0,45
261,858ff2d9-4b66-44ec-8b27-614bc832d176,36793052,3165,3102,63,46
261,858ff2d9-4b66-44ec-8b27-614bc832d176,36793052,3301,3168,133,47
261,858ff2d9-4b66-44ec-8b27-614bc832d176,36793052,3568,3324,244,48
261,858ff2d9-4b66-44ec-8b27-614bc832d176,36793052,3740,3569,171,51
261,858ff2d9-4b66-44ec-8b27-614bc832d176,36793052,3842,3756,86,52
261,858ff2d9-4b66-44ec-8b27-614bc832d176,36793052,4155,3865,290,59
261,858ff2d9-4b66-44ec-8b27-614bc832d176,36793052,4264,4163,101,60
261,858ff2d9-4b66-44ec-8b27-614bc832d176,36805051,1104,14,1090,0
261,858ff2d9-4b66-44ec-8b27-614bc832d176,36805051,3035,1169,1866,1
261,858ff2d9-4b66-44ec-8b27-614bc832d176,36805051,4644,3043,1601,2
261,858ff2d9-4b66-44ec-8b27-614bc832d176,36794105,902,47,855,0
261,858ff2d9-4b66-44ec-8b27-614bc832d176,36794105,1140,929,211,1
261,858ff2d9-4b66-44ec-8b27-614bc832d176,36794105,2015,1163,852,11
261,858ff2d9-4b66-44ec-8b27-614bc832d176,36794105,2418,2045,373,19
261,858ff2d9-4b66-44ec-8b27-614bc832d176,36794105,2425,2421,4,20
261,858ff2d9-4b66-44ec-8b27-614bc832d176,36794105,2566,2433,133,24
261,858ff2d9-4b66-44ec-8b27-614bc832d176,36794105,2836,2567,269,25
261,858ff2d9-4b66-44ec-8b27-614bc832d176,36794105,2995,2858,137,27
261,858ff2d9-4b66-44ec-8b27-614bc832d176,36794105,3931,3036,895,28
261,858ff2d9-4b66-44ec-8b27-614bc832d176,36794105,4346,3937,409,29
261,858ff2d9-4b66-44ec-8b27-614bc832d176,36794105,4342,4170,-172,43
261,858ff2d9-4b66-44ec-8b27-614bc832d176,36794105,4168,3809,-359,44
261,858ff2d9-4b66-44ec-8b27-614bc832d176,36794105,3774,0,-3774,45
259,9d82de59-0e76-4eba-9783-f3ad0e782827,36829391,72,1,71,0
259,9d82de59-0e76-4eba-9783-f3ad0e782827,36829391,680,73,607,1
259,9d82de59-0e76-4eba-9783-f3ad0e782827,36829391,717,692,25,8
259,9d82de59-0e76-4eba-9783-f3ad0e782827,36829391,760,727,33,9
259,9d82de59-0e76-4eba-9783-f3ad0e782827,36829391,854,769,85,10
259,9d82de59-0e76-4eba-9783-f3ad0e782827,36829391,990,860,130,18
259,9d82de59-0e76-4eba-9783-f3ad0e782827,36829391,1122,995,127,19
259,9d82de59-0e76-4eba-9783-f3ad0e782827,36829391,1329,1121,208,20
259,9d82de59-0e76-4eba-9783-f3ad0e782827,36829391,1642,1336,306,21
259,9d82de59-0e76-4eba-9783-f3ad0e782827,36829391,1654,1654,0,22
259,9d82de59-0e76-4eba-9783-f3ad0e782827,36829574,423,16,407,0
259,9d82de59-0e76-4eba-9783-f3ad0e782827,36829574,558,441,117,1
259,8ec49700-acff-46b1-b935-ff7f36af8c7b,36827725,132,7,125,0
259,8ec49700-acff-46b1-b935-ff7f36af8c7b,36827725,131,131,0,1
261,4d774b4c-2b62-4796-bb94-ad14a9bb2595,36824902,493,6,487,0
261,4d774b4c-2b62-4796-bb94-ad14a9bb2595,36824902,658,468,190,1
261,4d774b4c-2b62-4796-bb94-ad14a9bb2595,36824902,513,38,-475,2
261,4d774b4c-2b62-4796-bb94-ad14a9bb2595,36824902,36,35,-1,3
261,4d774b4c-2b62-4796-bb94-ad14a9bb2595,36824902,532,65,467,4
261,4d774b4c-2b62-4796-bb94-ad14a9bb2595,36824902,573,539,34,8
261,4d774b4c-2b62-4796-bb94-ad14a9bb2595,36824902,777,585,192,9
261,4d774b4c-2b62-4796-bb94-ad14a9bb2595,36824902,1050,796,254,10
261,4d774b4c-2b62-4796-bb94-ad14a9bb2595,36824902,1093,1061,32,11
261,4d774b4c-2b62-4796-bb94-ad14a9bb2595,36824902,2154,1111,1043,13
261,4d774b4c-2b62-4796-bb94-ad14a9bb2595,36824902,2977,2157,820,14
261,4d774b4c-2b62-4796-bb94-ad14a9bb2595,36824902,3003,2983,20,15
261,4d774b4c-2b62-4796-bb94-ad14a9bb2595,36824902,3319,3015,304,21
261,4d774b4c-2b62-4796-bb94-ad14a9bb2595,36824902,3601,3338,263,23
261,4d774b4c-2b62-4796-bb94-ad14a9bb2595,36824902,3836,3557,279,24
261,4d774b4c-2b62-4796-bb94-ad14a9bb2595,36824902,4550,3851,699,31
261,4d774b4c-2b62-4796-bb94-ad14a9bb2595,36824902,5024,4568,456,37
261,4d774b4c-2b62-4796-bb94-ad14a9bb2595,36824902,5083,5036,47,38
261,4d774b4c-2b62-4796-bb94-ad14a9bb2595,36824902,5067,4723,-344,42
261,4d774b4c-2b62-4796-bb94-ad14a9bb2595,36824902,4708,4328,-380,44
261,4d774b4c-2b62-4796-bb94-ad14a9bb2595,36824902,4945,4348,597,48
261,4d774b4c-2b62-4796-bb94-ad14a9bb2595,36824902,5366,4960,406,50
261,4d774b4c-2b62-4796-bb94-ad14a9bb2595,36824902,5472,5390,82,52
261,4d774b4c-2b62-4796-bb94-ad14a9bb2595,36824902,5431,4675,-756,53
261,fe5ffb8d-f70e-4da6-a9f8-40c97c15ce9d,36783521,794,29,765,0
261,fe5ffb8d-f70e-4da6-a9f8-40c97c15ce9d,36783521,1367,816,551,1
261,fe5ffb8d-f70e-4da6-a9f8-40c97c15ce9d,36783521,2103,1370,733,2
261,fe5ffb8d-f70e-4da6-a9f8-40c97c15ce9d,36783521,4182,2148,2034,3
261,fe5ffb8d-f70e-4da6-a9f8-40c97c15ce9d,36783521,4461,4194,267,11
261,fe5ffb8d-f70e-4da6-a9f8-40c97c15ce9d,36783521,4970,4490,480,16
261,fe5ffb8d-f70e-4da6-a9f8-40c97c15ce9d,36783521,5892,4980,912,17
261,fe5ffb8d-f70e-4da6-a9f8-40c97c15ce9d,36783521,7909,5935,1974,18
261,fe5ffb8d-f70e-4da6-a9f8-40c97c15ce9d,36783521,10147,7918,2229,19
261,fe5ffb8d-f70e-4da6-a9f8-40c97c15ce9d,36783521,10148,9912,-236,20
261,fe5ffb8d-f70e-4da6-a9f8-40c97c15ce9d,36783521,10767,10048,719,21
261,fe5ffb8d-f70e-4da6-a9f8-40c97c15ce9d,36783521,10675,9840,-835,22
261,fe5ffb8d-f70e-4da6-a9f8-40c97c15ce9d,36783521,9835,7801,-2034,23
261,fe5ffb8d-f70e-4da6-a9f8-40c97c15ce9d,36783521,7779,7585,-194,24
259,22c4fbf7-2a2b-4d26-a8a4-6e7b3306b23f,36838347,24,1,23,0
259,22c4fbf7-2a2b-4d26-a8a4-6e7b3306b23f,36838347,106,25,81,1
259,22c4fbf7-2a2b-4d26-a8a4-6e7b3306b23f,36838347,185,107,78,2
259,22c4fbf7-2a2b-4d26-a8a4-6e7b3306b23f,36838347,572,188,384,3
259,22c4fbf7-2a2b-4d26-a8a4-6e7b3306b23f,36838347,644,573,71,6
259,22c4fbf7-2a2b-4d26-a8a4-6e7b3306b23f,36838347,648,645,3,7
259,22c4fbf7-2a2b-4d26-a8a4-6e7b3306b23f,36838347,684,649,35,8
259,22c4fbf7-2a2b-4d26-a8a4-6e7b3306b23f,36838347,800,688,112,9
259,22c4fbf7-2a2b-4d26-a8a4-6e7b3306b23f,36838347,973,802,171,10
259,22c4fbf7-2a2b-4d26-a8a4-6e7b3306b23f,36838347,974,974,0,14
259,22c4fbf7-2a2b-4d26-a8a4-6e7b3306b23f,36838347,1092,980,112,15
259,22c4fbf7-2a2b-4d26-a8a4-6e7b3306b23f,36838347,1331,1095,236,16
259,22c4fbf7-2a2b-4d26-a8a4-6e7b3306b23f,36838347,1336,1333,3,17
259,22c4fbf7-2a2b-4d26-a8a4-6e7b3306b23f,36838347,1568,1347,221,20
259,22c4fbf7-2a2b-4d26-a8a4-6e7b3306b23f,36838347,1690,1575,115,21
259,22c4fbf7-2a2b-4d26-a8a4-6e7b3306b23f,36838347,1783,1692,91,23
259,22c4fbf7-2a2b-4d26-a8a4-6e7b3306b23f,36838347,1840,1785,55,26
259,22c4fbf7-2a2b-4d26-a8a4-6e7b3306b23f,36838347,1931,1843,88,27
259,22c4fbf7-2a2b-4d26-a8a4-6e7b3306b23f,36838347,2418,1947,471,28
259,22c4fbf7-2a2b-4d26-a8a4-6e7b3306b23f,36838347,2437,2422,15,29
259,22c4fbf7-2a2b-4d26-a8a4-6e7b3306b23f,36838347,2520,2441,79,40
259,22c4fbf7-2a2b-4d26-a8a4-6e7b3306b23f,36838347,2578,2524,54,41
259,22c4fbf7-2a2b-4d26-a8a4-6e7b3306b23f,36838347,2885,2581,304,43
259,22c4fbf7-2a2b-4d26-a8a4-6e7b3306b23f,36838347,3470,2886,584,44
259,22c4fbf7-2a2b-4d26-a8a4-6e7b3306b23f,36838347,3517,3478,39,46
259,22c4fbf7-2a2b-4d26-a8a4-6e7b3306b23f,36838347,3879,3527,352,47
261,507e54ef-c191-46cb-b513-8642e15d21e5,36844425,173,18,155,0
261,507e54ef-c191-46cb-b513-8642e15d21e5,36844425,359,196,163,1
261,507e54ef-c191-46cb-b513-8642e15d21e5,36844425,551,364,187,2
261,507e54ef-c191-46cb-b513-8642e15d21e5,36844425,833,596,237,3
261,507e54ef-c191-46cb-b513-8642e15d21e5,36844425,1128,853,275,5
261,507e54ef-c191-46cb-b513-8642e15d21e5,36844425,1124,1113,-11,8
261,507e54ef-c191-46cb-b513-8642e15d21e5,36844425,1120,1116,4,9
261,507e54ef-c191-46cb-b513-8642e15d21e5,36844425,1128,0,-1128,10
261,507e54ef-c191-46cb-b513-8642e15d21e5,36844425,45,1,44,11
261,507e54ef-c191-46cb-b513-8642e15d21e5,36843386,420,32,388,0
261,507e54ef-c191-46cb-b513-8642e15d21e5,36843386,810,456,354,1
261,507e54ef-c191-46cb-b513-8642e15d21e5,36843386,1413,814,599,2
261,507e54ef-c191-46cb-b513-8642e15d21e5,36843386,2244,1472,772,3
261,507e54ef-c191-46cb-b513-8642e15d21e5,36843386,5247,2292,2955,5
261,507e54ef-c191-46cb-b513-8642e15d21e5,36843386,4802,3294,-1508,6
261,507e54ef-c191-46cb-b513-8642e15d21e5,36843386,6661,4314,2347,7
261,507e54ef-c191-46cb-b513-8642e15d21e5,36843386,6786,3886,-2900,8
261,507e54ef-c191-46cb-b513-8642e15d21e5,36843386,6988,3769,3219,9
261,507e54ef-c191-46cb-b513-8642e15d21e5,36843071,1412,32,1380,0
261,507e54ef-c191-46cb-b513-8642e15d21e5,36834757,445,38,407,0
261,507e54ef-c191-46cb-b513-8642e15d21e5,36834757,705,450,255,1
261,507e54ef-c191-46cb-b513-8642e15d21e5,36834757,1436,753,683,2
261,507e54ef-c191-46cb-b513-8642e15d21e5,36834757,2268,1467,801,3
261,507e54ef-c191-46cb-b513-8642e15d21e5,36834757,2270,2269,1,4
261,736d16cc-25ce-4c90-9d89-4e9c452c2d9a,36848411,80,5,75,0
261,736d16cc-25ce-4c90-9d89-4e9c452c2d9a,36848411,628,100,528,1
261,736d16cc-25ce-4c90-9d89-4e9c452c2d9a,36848411,1098,637,461,2
261,736d16cc-25ce-4c90-9d89-4e9c452c2d9a,36848411,1290,1110,180,4
261,736d16cc-25ce-4c90-9d89-4e9c452c2d9a,36848411,2534,1298,1236,5
261,736d16cc-25ce-4c90-9d89-4e9c452c2d9a,36848411,3196,2553,643,6
261,736d16cc-25ce-4c90-9d89-4e9c452c2d9a,36843375,527,41,486,0
261,736d16cc-25ce-4c90-9d89-4e9c452c2d9a,36843375,630,537,93,1
261,736d16cc-25ce-4c90-9d89-4e9c452c2d9a,36843375,1821,634,1187,2
261,736d16cc-25ce-4c90-9d89-4e9c452c2d9a,36843375,1905,1836,69,3
261,736d16cc-25ce-4c90-9d89-4e9c452c2d9a,36843375,4331,1949,2382,4
261,736d16cc-25ce-4c90-9d89-4e9c452c2d9a,36843375,5529,3804,1725,5
261,736d16cc-25ce-4c90-9d89-4e9c452c2d9a,36843375,6130,5581,549,6
261,736d16cc-25ce-4c90-9d89-4e9c452c2d9a,36843375,6456,6165,291,7
261,736d16cc-25ce-4c90-9d89-4e9c452c2d9a,36843375,7982,6458,1524,8
261,736d16cc-25ce-4c90-9d89-4e9c452c2d9a,36843375,8144,7994,150,9
261,2a24ffc7-deaf-4e4d-99fb-4f675d36d829,36871390,174,3,171,0
261,2a24ffc7-deaf-4e4d-99fb-4f675d36d829,36871390,299,196,103,1
261,2a24ffc7-deaf-4e4d-99fb-4f675d36d829,36871390,665,311,354,9
261,2a24ffc7-deaf-4e4d-99fb-4f675d36d829,36871390,845,682,163,13
261,2a24ffc7-deaf-4e4d-99fb-4f675d36d829,36871390,861,847,14,14
261,2a24ffc7-deaf-4e4d-99fb-4f675d36d829,36871390,916,863,53,15
261,2a24ffc7-deaf-4e4d-99fb-4f675d36d829,36871390,998,917,81,16
261,2a24ffc7-deaf-4e4d-99fb-4f675d36d829,36871390,1816,1019,797,20
261,2a24ffc7-deaf-4e4d-99fb-4f675d36d829,36871390,2336,1855,481,25
261,2a24ffc7-deaf-4e4d-99fb-4f675d36d829,36871390,2830,2371,459,26
261,2a24ffc7-deaf-4e4d-99fb-4f675d36d829,36871390,2891,2842,49,27
261,411efe87-b340-42cf-812b-a489dd9f8b8f,36865435,130,12,118,0
261,411efe87-b340-42cf-812b-a489dd9f8b8f,36865435,163,131,32,1
261,411efe87-b340-42cf-812b-a489dd9f8b8f,36865435,180,164,16,2
261,411efe87-b340-42cf-812b-a489dd9f8b8f,36865435,455,181,274,3
261,411efe87-b340-42cf-812b-a489dd9f8b8f,36865435,1042,460,582,5
261,411efe87-b340-42cf-812b-a489dd9f8b8f,36865435,1966,1069,897,8
261,411efe87-b340-42cf-812b-a489dd9f8b8f,36865435,2638,1979,659,12
261,411efe87-b340-42cf-812b-a489dd9f8b8f,36865435,2880,2667,213,13
261,411efe87-b340-42cf-812b-a489dd9f8b8f,36865435,3737,2897,840,30
261,411efe87-b340-42cf-812b-a489dd9f8b8f,36865435,4520,3762,758,31
261,411efe87-b340-42cf-812b-a489dd9f8b8f,36865435,4700,4556,144,33
261,411efe87-b340-42cf-812b-a489dd9f8b8f,36847382,2612,18,2594,0
261,411efe87-b340-42cf-812b-a489dd9f8b8f,36847382,6015,2613,3402,1
261,411efe87-b340-42cf-812b-a489dd9f8b8f,36847382,6708,6031,677,2
261,411efe87-b340-42cf-812b-a489dd9f8b8f,36847382,6104,0,-6104,3
261,411efe87-b340-42cf-812b-a489dd9f8b8f,36847382,468,34,434,6
261,411efe87-b340-42cf-812b-a489dd9f8b8f,36847382,1138,524,614,7
261,411efe87-b340-42cf-812b-a489dd9f8b8f,36847382,1357,1154,203,9
261,411efe87-b340-42cf-812b-a489dd9f8b8f,36847382,1534,1379,155,10
261,5b4e39bc-d46d-484f-858f-74f0e6756fae,36881494,742,7,735,0
261,5b4e39bc-d46d-484f-858f-74f0e6756fae,36881494,1197,770,427,1
261,5b4e39bc-d46d-484f-858f-74f0e6756fae,36881494,1347,1206,141,2
261,5b4e39bc-d46d-484f-858f-74f0e6756fae,36881494,1283,259,-1024,10
261,5b4e39bc-d46d-484f-858f-74f0e6756fae,36881494,192,36,-156,11
261,5b4e39bc-d46d-484f-858f-74f0e6756fae,36881494,4324,59,4265,12
261,5b4e39bc-d46d-484f-858f-74f0e6756fae,36881494,4321,4311,-10,13
261,5b4e39bc-d46d-484f-858f-74f0e6756fae,36880779,109,5,104,0
261,5b4e39bc-d46d-484f-858f-74f0e6756fae,36880779,438,113,325,1
261,5b4e39bc-d46d-484f-858f-74f0e6756fae,36880779,742,453,289,2
261,5b4e39bc-d46d-484f-858f-74f0e6756fae,36880779,958,755,203,3
261,5b4e39bc-d46d-484f-858f-74f0e6756fae,36880779,1285,976,309,19
261,5b4e39bc-d46d-484f-858f-74f0e6756fae,36880779,1968,1293,675,26
261,5b4e39bc-d46d-484f-858f-74f0e6756fae,36880779,2284,1991,293,27
261,5b4e39bc-d46d-484f-858f-74f0e6756fae,36880779,2489,2290,199,28
261,5b4e39bc-d46d-484f-858f-74f0e6756fae,36880779,2480,2457,23,29
261,5b4e39bc-d46d-484f-858f-74f0e6756fae,36880779,2733,2473,260,37
261,5b4e39bc-d46d-484f-858f-74f0e6756fae,36880779,2933,2741,192,38
261,5b4e39bc-d46d-484f-858f-74f0e6756fae,36880779,2949,2934,15,39
261,5b4e39bc-d46d-484f-858f-74f0e6756fae,36880779,2990,2951,39,40
261,5b4e39bc-d46d-484f-858f-74f0e6756fae,36880779,3006,2992,14,41
261,5b4e39bc-d46d-484f-858f-74f0e6756fae,36880779,3105,3007,98,42
261,5b4e39bc-d46d-484f-858f-74f0e6756fae,36880779,3466,3158,308,43
261,5b4e39bc-d46d-484f-858f-74f0e6756fae,36880779,3680,828,-2852,44
261,5b4e39bc-d46d-484f-858f-74f0e6756fae,36880779,757,0,-757,45
259,50411a5f-5ea9-44da-8328-fd37e9019de7,36881268,562,7,555,0
259,50411a5f-5ea9-44da-8328-fd37e9019de7,36881268,1408,565,843,3
259,50411a5f-5ea9-44da-8328-fd37e9019de7,36881268,1409,1409,0,4
259,50411a5f-5ea9-44da-8328-fd37e9019de7,36881268,1471,1417,54,7
259,50411a5f-5ea9-44da-8328-fd37e9019de7,36881268,1535,1473,62,9
259,50411a5f-5ea9-44da-8328-fd37e9019de7,36881268,1570,1539,31,10
259,50411a5f-5ea9-44da-8328-fd37e9019de7,36881268,2120,1575,545,11
259,50411a5f-5ea9-44da-8328-fd37e9019de7,36881268,2339,2121,218,21
259,50411a5f-5ea9-44da-8328-fd37e9019de7,36881268,2350,2343,7,22
259,50411a5f-5ea9-44da-8328-fd37e9019de7,36881268,2516,2366,150,23
259,50411a5f-5ea9-44da-8328-fd37e9019de7,36881268,2550,2532,18,24
261,0e64319d-4891-4b50-9bba-6351c891587a,36890398,223,31,192,0
261,0e64319d-4891-4b50-9bba-6351c891587a,36890398,765,246,519,1
261,0e64319d-4891-4b50-9bba-6351c891587a,36890398,1867,781,1086,2
261,0e64319d-4891-4b50-9bba-6351c891587a,36890398,3078,1890,1188,3
261,0e64319d-4891-4b50-9bba-6351c891587a,36890398,3565,3113,452,4
261,0e64319d-4891-4b50-9bba-6351c891587a,36890398,4176,3577,599,5
261,0e64319d-4891-4b50-9bba-6351c891587a,36890398,5497,4200,1297,6
261,0e64319d-4891-4b50-9bba-6351c891587a,36890398,6820,5623,1197,7
261,0e64319d-4891-4b50-9bba-6351c891587a,36890398,6812,6051,-761,9
261,0e64319d-4891-4b50-9bba-6351c891587a,36889828,312,9,303,0
261,0e64319d-4891-4b50-9bba-6351c891587a,36889828,659,330,329,1
261,0e64319d-4891-4b50-9bba-6351c891587a,36889828,1033,674,359,4
261,0e64319d-4891-4b50-9bba-6351c891587a,36889828,1107,1050,57,5
261,0e64319d-4891-4b50-9bba-6351c891587a,36889828,1859,1126,733,6
261,0e64319d-4891-4b50-9bba-6351c891587a,36889828,3020,1894,1126,13
261,0e64319d-4891-4b50-9bba-6351c891587a,36889828,3791,3082,709,14
261,0e64319d-4891-4b50-9bba-6351c891587a,36855834,370,26,344,0
261,0e64319d-4891-4b50-9bba-6351c891587a,36855834,801,373,428,1
261,0e64319d-4891-4b50-9bba-6351c891587a,36855834,1113,805,308,2
261,0e64319d-4891-4b50-9bba-6351c891587a,36855834,1213,1129,84,3
261,0e64319d-4891-4b50-9bba-6351c891587a,36855834,1206,858,-348,4
261,0e64319d-4891-4b50-9bba-6351c891587a,36855834,856,854,-2,5
261,0e64319d-4891-4b50-9bba-6351c891587a,36847556,424,43,381,0
261,0e64319d-4891-4b50-9bba-6351c891587a,36847556,768,446,322,1
261,0e64319d-4891-4b50-9bba-6351c891587a,36847556,1369,792,577,2
261,0e64319d-4891-4b50-9bba-6351c891587a,36847556,1995,1384,611,5
261,0e64319d-4891-4b50-9bba-6351c891587a,36847556,2027,1998,29,7
261,0e64319d-4891-4b50-9bba-6351c891587a,36847556,2490,2057,433,8
261,0e64319d-4891-4b50-9bba-6351c891587a,36847556,3333,2510,823,12
261,0e64319d-4891-4b50-9bba-6351c891587a,36847556,3803,3359,444,13
261,0e64319d-4891-4b50-9bba-6351c891587a,36847556,4314,3862,452,14
261,0e64319d-4891-4b50-9bba-6351c891587a,36847556,4456,4348,108,20
261,0e64319d-4891-4b50-9bba-6351c891587a,36891428,465,3,462,0
261,0e64319d-4891-4b50-9bba-6351c891587a,36891428,577,489,88,1
261,0e64319d-4891-4b50-9bba-6351c891587a,36891428,684,602,82,6
261,0e64319d-4891-4b50-9bba-6351c891587a,36891428,1014,726,288,7
261,0e64319d-4891-4b50-9bba-6351c891587a,36891428,1391,1050,341,12
261,0e64319d-4891-4b50-9bba-6351c891587a,36891428,2128,1396,732,16
261,0e64319d-4891-4b50-9bba-6351c891587a,36891428,2981,2152,829,17
261,0e64319d-4891-4b50-9bba-6351c891587a,36891428,3712,2985,727,18
261,0e64319d-4891-4b50-9bba-6351c891587a,36891428,5534,3753,1781,22
261,0e64319d-4891-4b50-9bba-6351c891587a,36891428,5806,5567,239,23
261,0e64319d-4891-4b50-9bba-6351c891587a,36891428,5885,5811,74,24
261,0e64319d-4891-4b50-9bba-6351c891587a,36891428,5886,5886,0,25
261,0e64319d-4891-4b50-9bba-6351c891587a,36891428,6316,5887,429,26
261,0e64319d-4891-4b50-9bba-6351c891587a,36891428,6327,6320,7,27
261,0e64319d-4891-4b50-9bba-6351c891587a,36891428,6913,6377,536,29
261,0e64319d-4891-4b50-9bba-6351c891587a,36891428,7555,6926,629,30
261,0e64319d-4891-4b50-9bba-6351c891587a,36891428,10398,7618,2780,31
261,0e64319d-4891-4b50-9bba-6351c891587a,36891428,11399,10448,951,32
261,0e64319d-4891-4b50-9bba-6351c891587a,36891428,11387,10872,-515,33
261,0e64319d-4891-4b50-9bba-6351c891587a,36891428,10820,10508,-312,34
261,be6b0d55-191a-42d0-a879-eeecc544dc05,36911896,185,9,176,0
261,be6b0d55-191a-42d0-a879-eeecc544dc05,36911896,222,186,36,3
261,be6b0d55-191a-42d0-a879-eeecc544dc05,36911896,224,223,1,4
261,be6b0d55-191a-42d0-a879-eeecc544dc05,36911896,303,225,78,6
261,be6b0d55-191a-42d0-a879-eeecc544dc05,36911896,551,307,244,7
261,be6b0d55-191a-42d0-a879-eeecc544dc05,36911896,706,559,147,8
261,be6b0d55-191a-42d0-a879-eeecc544dc05,36911896,836,716,120,9
261,be6b0d55-191a-42d0-a879-eeecc544dc05,36911896,867,838,29,10
261,be6b0d55-191a-42d0-a879-eeecc544dc05,36911896,909,869,40,11
261,be6b0d55-191a-42d0-a879-eeecc544dc05,36911896,956,910,46,12
261,be6b0d55-191a-42d0-a879-eeecc544dc05,36911896,972,957,15,13
261,be6b0d55-191a-42d0-a879-eeecc544dc05,36911896,998,973,25,14
261,be6b0d55-191a-42d0-a879-eeecc544dc05,36911896,1035,1000,35,20
261,be6b0d55-191a-42d0-a879-eeecc544dc05,36911896,1163,1044,119,21
261,be6b0d55-191a-42d0-a879-eeecc544dc05,36911896,1180,1165,15,22
261,be6b0d55-191a-42d0-a879-eeecc544dc05,36911896,1181,1181,0,23
261,be6b0d55-191a-42d0-a879-eeecc544dc05,36911896,1184,1182,2,27
261,be6b0d55-191a-42d0-a879-eeecc544dc05,36911896,1183,1183,0,28
261,be6b0d55-191a-42d0-a879-eeecc544dc05,36911896,1210,1184,26,30
261,be6b0d55-191a-42d0-a879-eeecc544dc05,36911896,1215,1211,4,31
261,be6b0d55-191a-42d0-a879-eeecc544dc05,36911896,1215,1215,0,32
261,be6b0d55-191a-42d0-a879-eeecc544dc05,36911766,339,22,317,0
261,be6b0d55-191a-42d0-a879-eeecc544dc05,36911766,624,367,257,1
261,be6b0d55-191a-42d0-a879-eeecc544dc05,36911766,699,625,74,2
261,be6b0d55-191a-42d0-a879-eeecc544dc05,36911766,711,700,11,3
261,be6b0d55-191a-42d0-a879-eeecc544dc05,36911766,988,720,268,9
261,be6b0d55-191a-42d0-a879-eeecc544dc05,36911766,988,987,1,10
261,be6b0d55-191a-42d0-a879-eeecc544dc05,36911766,988,987,-1,10
261,be6b0d55-191a-42d0-a879-eeecc544dc05,36909827,403,27,376,0
261,be6b0d55-191a-42d0-a879-eeecc544dc05,36909827,870,428,442,13
261,be6b0d55-191a-42d0-a879-eeecc544dc05,36909827,992,875,117,17
261,be6b0d55-191a-42d0-a879-eeecc544dc05,36909827,1235,1018,217,18
261,be6b0d55-191a-42d0-a879-eeecc544dc05,36909827,1918,1248,670,26
261,be6b0d55-191a-42d0-a879-eeecc544dc05,36909827,2346,1931,415,27
261,be6b0d55-191a-42d0-a879-eeecc544dc05,36909827,2348,2347,1,28
261,be6b0d55-191a-42d0-a879-eeecc544dc05,36909827,2686,2365,321,37
261,be6b0d55-191a-42d0-a879-eeecc544dc05,36909827,2955,2697,258,38
261,be6b0d55-191a-42d0-a879-eeecc544dc05,36909827,3561,2986,575,44
261,be6b0d55-191a-42d0-a879-eeecc544dc05,36909827,3859,3579,280,47
261,be6b0d55-191a-42d0-a879-eeecc544dc05,36909827,4874,3863,1011,54
261,be6b0d55-191a-42d0-a879-eeecc544dc05,36909827,5332,4920,412,55
261,be6b0d55-191a-42d0-a879-eeecc544dc05,36909827,5576,5338,238,59
261,be6b0d55-191a-42d0-a879-eeecc544dc05,36909827,5706,5595,111,60
261,be6b0d55-191a-42d0-a879-eeecc544dc05,36909827,6475,5733,742,61
261,be6b0d55-191a-42d0-a879-eeecc544dc05,36909827,6800,6507,293,62
261,be6b0d55-191a-42d0-a879-eeecc544dc05,36909827,6743,6068,-675,66
261,be6b0d55-191a-42d0-a879-eeecc544dc05,36909827,6058,6025,-33,67
261,be6b0d55-191a-42d0-a879-eeecc544dc05,36910766,447,44,403,0
261,be6b0d55-191a-42d0-a879-eeecc544dc05,36910766,481,456,25,1
261,be6b0d55-191a-42d0-a879-eeecc544dc05,36910766,1277,509,768,5
261,be6b0d55-191a-42d0-a879-eeecc544dc05,36910766,1301,1283,18,6
261,be6b0d55-191a-42d0-a879-eeecc544dc05,36910766,1921,1337,584,12
261,be6b0d55-191a-42d0-a879-eeecc544dc05,36910766,2504,1980,524,13
261,be6b0d55-191a-42d0-a879-eeecc544dc05,36910766,3349,2559,790,22
261,be6b0d55-191a-42d0-a879-eeecc544dc05,36910766,4870,3360,1510,23
261,be6b0d55-191a-42d0-a879-eeecc544dc05,36910766,5990,4907,1083,24
261,be6b0d55-191a-42d0-a879-eeecc544dc05,36906818,344,8,336,0
261,be6b0d55-191a-42d0-a879-eeecc544dc05,36906818,549,366,183,8
261,be6b0d55-191a-42d0-a879-eeecc544dc05,36906818,602,551,51,9
261,be6b0d55-191a-42d0-a879-eeecc544dc05,36906818,680,603,77,10
261,be6b0d55-191a-42d0-a879-eeecc544dc05,36906818,803,682,121,11
261,be6b0d55-191a-42d0-a879-eeecc544dc05,36906818,904,805,99,12
261,be6b0d55-191a-42d0-a879-eeecc544dc05,36906818,1003,916,87,13
261,be6b0d55-191a-42d0-a879-eeecc544dc05,36906818,1132,1011,121,23
261,be6b0d55-191a-42d0-a879-eeecc544dc05,36906818,1163,1134,29,24
261,be6b0d55-191a-42d0-a879-eeecc544dc05,36906818,1667,1164,503,25
261,be6b0d55-191a-42d0-a879-eeecc544dc05,36906818,1694,1674,20,26
261,be6b0d55-191a-42d0-a879-eeecc544dc05,36906818,2277,1705,572,40
261,be6b0d55-191a-42d0-a879-eeecc544dc05,36906818,2676,2289,387,41
261,be6b0d55-191a-42d0-a879-eeecc544dc05,36906818,2668,2049,-619,56
261,be6b0d55-191a-42d0-a879-eeecc544dc05,36906818,2009,1803,-206,57
261,be6b0d55-191a-42d0-a879-eeecc544dc05,36901907,244,10,234,0
261,be6b0d55-191a-42d0-a879-eeecc544dc05,36901907,431,251,180,1
261,be6b0d55-191a-42d0-a879-eeecc544dc05,36901907,577,435,142,2
261,be6b0d55-191a-42d0-a879-eeecc544dc05,36901907,588,584,4,3
261,be6b0d55-191a-42d0-a879-eeecc544dc05,36901907,1095,612,483,4
261,be6b0d55-191a-42d0-a879-eeecc544dc05,36901907,1140,1101,39,5
261,be6b0d55-191a-42d0-a879-eeecc544dc05,36901907,1179,1141,38,6
261,be6b0d55-191a-42d0-a879-eeecc544dc05,36901907,1414,1205,209,8
261,be6b0d55-191a-42d0-a879-eeecc544dc05,36901907,1478,1418,60,9
261,be6b0d55-191a-42d0-a879-eeecc544dc05,36901907,1873,1491,382,12
261,be6b0d55-191a-42d0-a879-eeecc544dc05,36901907,1886,1874,12,13
261,be6b0d55-191a-42d0-a879-eeecc544dc05,36901907,2386,1906,480,18
261,be6b0d55-191a-42d0-a879-eeecc544dc05,36901907,2958,2394,564,19
261,be6b0d55-191a-42d0-a879-eeecc544dc05,36901907,2960,2959,1,20
261,be6b0d55-191a-42d0-a879-eeecc544dc05,36901907,3270,2977,293,21
261,be6b0d55-191a-42d0-a879-eeecc544dc05,36901907,3518,3284,234,22
261,be6b0d55-191a-42d0-a879-eeecc544dc05,36901907,3710,3524,186,25
261,be6b0d55-191a-42d0-a879-eeecc544dc05,36901907,3752,3714,38,26
261,be6b0d55-191a-42d0-a879-eeecc544dc05,36901907,3868,3753,115,30
261,be6b0d55-191a-42d0-a879-eeecc544dc05,36895395,145,24,121,0
261,be6b0d55-191a-42d0-a879-eeecc544dc05,36895395,314,147,167,1
261,be6b0d55-191a-42d0-a879-eeecc544dc05,36895395,638,318,320,2
261,be6b0d55-191a-42d0-a879-eeecc544dc05,36895395,746,652,94,5
261,be6b0d55-191a-42d0-a879-eeecc544dc05,36895395,834,751,83,6
261,be6b0d55-191a-42d0-a879-eeecc544dc05,36895395,910,836,74,7
261,be6b0d55-191a-42d0-a879-eeecc544dc05,36895395,994,911,83,8
261,be6b0d55-191a-42d0-a879-eeecc544dc05,36895395,1036,995,41,9
261,be6b0d55-191a-42d0-a879-eeecc544dc05,36895395,1055,1037,18,10
261,be6b0d55-191a-42d0-a879-eeecc544dc05,36895395,1058,1057,1,11
261,be6b0d55-191a-42d0-a879-eeecc544dc05,36895395,1150,1071,79,17
261,be6b0d55-191a-42d0-a879-eeecc544dc05,36895395,1167,1152,15,18
261,be6b0d55-191a-42d0-a879-eeecc544dc05,36895395,1345,1170,175,21
261,be6b0d55-191a-42d0-a879-eeecc544dc05,36895395,1414,1349,65,22
261,be6b0d55-191a-42d0-a879-eeecc544dc05,36895395,1705,1416,289,23
261,be6b0d55-191a-42d0-a879-eeecc544dc05,36895395,3341,1713,1628,26
261,be6b0d55-191a-42d0-a879-eeecc544dc05,36895395,3364,3364,0,27
261,de464539-c74c-45d3-9b19-2aa06d91f421,36903865,564,16,548,0
261,de464539-c74c-45d3-9b19-2aa06d91f421,36910391,286,5,281,0
261,de464539-c74c-45d3-9b19-2aa06d91f421,36910391,534,288,246,1
261,de464539-c74c-45d3-9b19-2aa06d91f421,36910391,627,538,89,2
261,de464539-c74c-45d3-9b19-2aa06d91f421,36910391,915,631,284,6
261,de464539-c74c-45d3-9b19-2aa06d91f421,36910391,935,917,18,7
261,de464539-c74c-45d3-9b19-2aa06d91f421,36910391,1363,937,426,8
261,de464539-c74c-45d3-9b19-2aa06d91f421,36910391,1778,1380,398,13
261,de464539-c74c-45d3-9b19-2aa06d91f421,36910391,2122,1782,340,14
261,de464539-c74c-45d3-9b19-2aa06d91f421,36910391,2360,2159,201,15
261,de464539-c74c-45d3-9b19-2aa06d91f421,36910391,2323,0,-2323,17
261,77f75bce-1d3b-465e-9938-efaa8b6936c6,36914884,501,2,499,0
261,77f75bce-1d3b-465e-9938-efaa8b6936c6,36914884,636,517,119,1
261,77f75bce-1d3b-465e-9938-efaa8b6936c6,36914884,1114,655,459,11
261,77f75bce-1d3b-465e-9938-efaa8b6936c6,36914884,1638,1123,515,12
261,77f75bce-1d3b-465e-9938-efaa8b6936c6,36914884,883,47,836,21
261,77f75bce-1d3b-465e-9938-efaa8b6936c6,36914884,1346,885,461,22
261,77f75bce-1d3b-465e-9938-efaa8b6936c6,36914884,1255,0,-1255,30
259,21e01b49-50a0-4c48-ba07-011a51ee1bd7,36916606,64,5,59,0
259,21e01b49-50a0-4c48-ba07-011a51ee1bd7,36916606,181,66,115,2
259,21e01b49-50a0-4c48-ba07-011a51ee1bd7,36916606,246,182,64,3
259,21e01b49-50a0-4c48-ba07-011a51ee1bd7,36916606,259,247,12,4
259,21e01b49-50a0-4c48-ba07-011a51ee1bd7,36916606,364,261,103,9
259,21e01b49-50a0-4c48-ba07-011a51ee1bd7,36916606,483,367,116,10
259,21e01b49-50a0-4c48-ba07-011a51ee1bd7,36916606,491,485,6,11
259,21e01b49-50a0-4c48-ba07-011a51ee1bd7,36916606,641,492,149,18
259,21e01b49-50a0-4c48-ba07-011a51ee1bd7,36916606,780,646,134,19
259,21e01b49-50a0-4c48-ba07-011a51ee1bd7,36916606,859,784,75,20
259,21e01b49-50a0-4c48-ba07-011a51ee1bd7,36916606,891,865,26,25
259,21e01b49-50a0-4c48-ba07-011a51ee1bd7,36916606,1079,894,185,26
259,21e01b49-50a0-4c48-ba07-011a51ee1bd7,36916606,1108,1081,27,27
259,21e01b49-50a0-4c48-ba07-011a51ee1bd7,36916606,1193,1109,84,28
259,21e01b49-50a0-4c48-ba07-011a51ee1bd7,36916606,1305,1194,111,29
259,21e01b49-50a0-4c48-ba07-011a51ee1bd7,36916606,1309,1307,2,30
259,21e01b49-50a0-4c48-ba07-011a51ee1bd7,36916606,1407,1311,96,34
259,21e01b49-50a0-4c48-ba07-011a51ee1bd7,36916606,1559,1409,150,35
261,fe8d7db6-850f-4a8a-92fa-dda04935f86e,36920665,212,11,201,0
261,fe8d7db6-850f-4a8a-92fa-dda04935f86e,36920665,846,213,633,1
261,fe8d7db6-850f-4a8a-92fa-dda04935f86e,36920665,1243,873,370,16
261,fe8d7db6-850f-4a8a-92fa-dda04935f86e,36920665,1610,1261,349,17
261,fe8d7db6-850f-4a8a-92fa-dda04935f86e,36920665,1754,1630,124,23
261,fe8d7db6-850f-4a8a-92fa-dda04935f86e,36920665,2270,1812,458,24
261,fe8d7db6-850f-4a8a-92fa-dda04935f86e,36920665,2585,2279,306,25
261,fe8d7db6-850f-4a8a-92fa-dda04935f86e,36920665,3470,2639,831,26
261,fe8d7db6-850f-4a8a-92fa-dda04935f86e,36920665,5456,3559,1897,27
261,fe8d7db6-850f-4a8a-92fa-dda04935f86e,36920665,5442,5101,-341,30
261,fe8d7db6-850f-4a8a-92fa-dda04935f86e,36920665,5099,5097,-2,31
261,fe8d7db6-850f-4a8a-92fa-dda04935f86e,36882292,215,4,211,0
261,fe8d7db6-850f-4a8a-92fa-dda04935f86e,36882292,261,219,42,1
261,fe8d7db6-850f-4a8a-92fa-dda04935f86e,36882292,312,264,48,2
261,fe8d7db6-850f-4a8a-92fa-dda04935f86e,36882292,394,313,81,3
261,fe8d7db6-850f-4a8a-92fa-dda04935f86e,36882292,354,0,-354,5
261,fe8d7db6-850f-4a8a-92fa-dda04935f86e,36882292,2,1,1,6
261,fe8d7db6-850f-4a8a-92fa-dda04935f86e,36882292,1243,20,1223,8
261,fe8d7db6-850f-4a8a-92fa-dda04935f86e,36882292,1424,1247,177,10
261,fe8d7db6-850f-4a8a-92fa-dda04935f86e,36882292,1534,1426,108,11
261,fe8d7db6-850f-4a8a-92fa-dda04935f86e,36882292,1541,1536,5,12
261,fe8d7db6-850f-4a8a-92fa-dda04935f86e,36912992,266,6,260,0
261,fe8d7db6-850f-4a8a-92fa-dda04935f86e,36912992,648,275,373,2
261,fe8d7db6-850f-4a8a-92fa-dda04935f86e,36912992,816,661,155,9
261,fe8d7db6-850f-4a8a-92fa-dda04935f86e,36912992,900,817,83,10
261,fe8d7db6-850f-4a8a-92fa-dda04935f86e,36912992,1149,907,242,11
261,fe8d7db6-850f-4a8a-92fa-dda04935f86e,36912992,1485,1151,334,12
261,fe8d7db6-850f-4a8a-92fa-dda04935f86e,36912992,1603,1504,99,13
261,fe8d7db6-850f-4a8a-92fa-dda04935f86e,36912992,1992,1611,381,15
261,fe8d7db6-850f-4a8a-92fa-dda04935f86e,36912992,2196,1997,199,19
261,fe8d7db6-850f-4a8a-92fa-dda04935f86e,36912992,2550,2197,353,20
261,fe8d7db6-850f-4a8a-92fa-dda04935f86e,36912992,2736,2582,154,27
261,fe8d7db6-850f-4a8a-92fa-dda04935f86e,36912992,2729,2545,-184,42
261,fe8d7db6-850f-4a8a-92fa-dda04935f86e,36912572,17,17,0,0
261,fe8d7db6-850f-4a8a-92fa-dda04935f86e,36912572,247,44,203,1
261,fe8d7db6-850f-4a8a-92fa-dda04935f86e,36912572,257,248,9,2
261,fe8d7db6-850f-4a8a-92fa-dda04935f86e,36912572,413,258,155,3
261,fe8d7db6-850f-4a8a-92fa-dda04935f86e,36912572,519,415,104,4
261,fe8d7db6-850f-4a8a-92fa-dda04935f86e,36912572,700,523,177,5
261,fe8d7db6-850f-4a8a-92fa-dda04935f86e,36912572,1811,716,1095,8
261,fe8d7db6-850f-4a8a-92fa-dda04935f86e,36912572,2416,1818,598,9
24,157a2356-044c-4c76-97e7-571d3f481320,36927523,5,5,0,0
24,157a2356-044c-4c76-97e7-571d3f481320,36927523,281,12,269,1
24,157a2356-044c-4c76-97e7-571d3f481320,36927523,299,284,15,2
24,157a2356-044c-4c76-97e7-571d3f481320,36927523,495,304,191,14
24,157a2356-044c-4c76-97e7-571d3f481320,36927523,576,496,80,15
24,157a2356-044c-4c76-97e7-571d3f481320,36927523,687,580,107,22
24,157a2356-044c-4c76-97e7-571d3f481320,36927523,750,690,60,23
24,157a2356-044c-4c76-97e7-571d3f481320,36927523,833,752,81,32
24,157a2356-044c-4c76-97e7-571d3f481320,36927523,1072,837,235,33
24,157a2356-044c-4c76-97e7-571d3f481320,36927523,1344,1085,259,34
24,157a2356-044c-4c76-97e7-571d3f481320,36927523,1419,1346,73,35
24,157a2356-044c-4c76-97e7-571d3f481320,36927523,1432,1421,11,36
24,157a2356-044c-4c76-97e7-571d3f481320,36927523,1468,1434,34,40
24,157a2356-044c-4c76-97e7-571d3f481320,36927523,1629,1472,157,41
261,4569a65a-f017-4a0b-b460-47c055243be1,36955531,757,6,751,0
261,4569a65a-f017-4a0b-b460-47c055243be1,36955531,1076,771,305,1
261,4569a65a-f017-4a0b-b460-47c055243be1,36955531,1946,1080,866,2
261,4569a65a-f017-4a0b-b460-47c055243be1,36955531,2546,1963,583,5
261,4569a65a-f017-4a0b-b460-47c055243be1,36955531,3276,2565,711,6
261,4569a65a-f017-4a0b-b460-47c055243be1,36955531,3936,3335,601,7
261,4569a65a-f017-4a0b-b460-47c055243be1,36955531,4372,3940,432,16
261,4569a65a-f017-4a0b-b460-47c055243be1,36961201,682,25,657,0
261,4569a65a-f017-4a0b-b460-47c055243be1,36961201,832,687,145,1
261,4569a65a-f017-4a0b-b460-47c055243be1,36961201,1162,838,324,2
261,4569a65a-f017-4a0b-b460-47c055243be1,36961201,1339,1168,171,3
261,4569a65a-f017-4a0b-b460-47c055243be1,36961201,1406,1343,63,4
261,4569a65a-f017-4a0b-b460-47c055243be1,36961201,1716,1410,306,9
261,4569a65a-f017-4a0b-b460-47c055243be1,36961201,1789,1723,66,10
261,4569a65a-f017-4a0b-b460-47c055243be1,36961201,1834,1790,44,11
261,4569a65a-f017-4a0b-b460-47c055243be1,36961201,1881,1836,45,12
261,4569a65a-f017-4a0b-b460-47c055243be1,36961201,1961,1896,65,18
261,4569a65a-f017-4a0b-b460-47c055243be1,36961201,3872,2153,1719,19
261,4569a65a-f017-4a0b-b460-47c055243be1,36941960,93,11,82,0
261,4569a65a-f017-4a0b-b460-47c055243be1,36941960,500,114,386,1
261,4569a65a-f017-4a0b-b460-47c055243be1,36941960,547,505,42,2
261,4569a65a-f017-4a0b-b460-47c055243be1,36941960,895,548,347,3
261,4569a65a-f017-4a0b-b460-47c055243be1,36951279,669,37,632,0
261,4569a65a-f017-4a0b-b460-47c055243be1,36951279,805,712,93,1
259,0e81172b-0532-4f3c-a57a-e2cf20ce109f,37003819,43,9,34,0
259,0e81172b-0532-4f3c-a57a-e2cf20ce109f,37003819,101,47,54,1
125,5d64a657-147f-481d-9147-45ee014a633f,37057689,72,4,68,0
125,5d64a657-147f-481d-9147-45ee014a633f,37057689,656,69,587,1
125,5d64a657-147f-481d-9147-45ee014a633f,37057689,661,657,4,2
125,5d64a657-147f-481d-9147-45ee014a633f,37057689,1079,675,404,143
125,5d64a657-147f-481d-9147-45ee014a633f,37057689,1092,1080,12,144
125,5d64a657-147f-481d-9147-45ee014a633f,37057689,1092,1080,-12,144
125,5d64a657-147f-481d-9147-45ee014a633f,37057689,1079,1066,-13,145
125,5d64a657-147f-481d-9147-45ee014a633f,37057689,1341,1072,269,177
125,5d64a657-147f-481d-9147-45ee014a633f,37057689,1341,1248,93,178
125,5d64a657-147f-481d-9147-45ee014a633f,37085244,200,197,-3,0
125,5d64a657-147f-481d-9147-45ee014a633f,37085244,195,195,0,1
125,5d64a657-147f-481d-9147-45ee014a633f,37085244,200,194,6,2
259,0c1b6eb4-7526-4dbf-aecb-ee20e7492d7a,37103039,125,8,117,0
259,0c1b6eb4-7526-4dbf-aecb-ee20e7492d7a,37103039,263,131,132,1
259,0c1b6eb4-7526-4dbf-aecb-ee20e7492d7a,37103039,566,270,296,2
259,0c1b6eb4-7526-4dbf-aecb-ee20e7492d7a,37103039,581,571,10,7
259,0c1b6eb4-7526-4dbf-aecb-ee20e7492d7a,37103039,723,599,124,8
259,0c1b6eb4-7526-4dbf-aecb-ee20e7492d7a,37103039,817,734,83,9
259,0c1b6eb4-7526-4dbf-aecb-ee20e7492d7a,37103039,908,818,90,10
259,4d3a069a-b7e5-4964-8b94-fdb4f9b13a29,37107450,91,2,89,0
259,4d3a069a-b7e5-4964-8b94-fdb4f9b13a29,37107450,151,93,58,4
259,4d3a069a-b7e5-4964-8b94-fdb4f9b13a29,37107450,182,154,28,10
259,4d3a069a-b7e5-4964-8b94-fdb4f9b13a29,37107450,217,174,43,11
259,4d3a069a-b7e5-4964-8b94-fdb4f9b13a29,37107450,350,229,121,12
259,4d3a069a-b7e5-4964-8b94-fdb4f9b13a29,37107450,506,361,145,16
259,4d3a069a-b7e5-4964-8b94-fdb4f9b13a29,37107450,529,508,21,23
259,4d3a069a-b7e5-4964-8b94-fdb4f9b13a29,37107450,554,532,22,24
259,4d3a069a-b7e5-4964-8b94-fdb4f9b13a29,37107450,714,554,160,26
259,4d3a069a-b7e5-4964-8b94-fdb4f9b13a29,37107450,1632,730,902,28
259,4d3a069a-b7e5-4964-8b94-fdb4f9b13a29,37107450,2235,1751,484,29
259,4d3a069a-b7e5-4964-8b94-fdb4f9b13a29,37109170,15,15,0,0
259,4d3a069a-b7e5-4964-8b94-fdb4f9b13a29,37109170,222,30,192,1
259,4d3a069a-b7e5-4964-8b94-fdb4f9b13a29,37109170,331,228,103,2
259,4d3a069a-b7e5-4964-8b94-fdb4f9b13a29,37109170,409,334,75,8
259,4d3a069a-b7e5-4964-8b94-fdb4f9b13a29,37107805,165,1,164,0
259,4d3a069a-b7e5-4964-8b94-fdb4f9b13a29,37107805,193,165,28,1
259,4d3a069a-b7e5-4964-8b94-fdb4f9b13a29,37107805,275,201,74,2
259,4d3a069a-b7e5-4964-8b94-fdb4f9b13a29,37107805,364,279,85,5
259,4d3a069a-b7e5-4964-8b94-fdb4f9b13a29,37107805,377,363,14,6
259,4d3a069a-b7e5-4964-8b94-fdb4f9b13a29,37107805,812,378,434,7
259,4d3a069a-b7e5-4964-8b94-fdb4f9b13a29,37107805,837,814,23,8
259,4d3a069a-b7e5-4964-8b94-fdb4f9b13a29,37107805,989,844,145,11
259,4d3a069a-b7e5-4964-8b94-fdb4f9b13a29,37107805,1792,990,802,12
259,4d3a069a-b7e5-4964-8b94-fdb4f9b13a29,37107945,93,9,84,0
259,4d3a069a-b7e5-4964-8b94-fdb4f9b13a29,37107945,122,95,27,1
259,4d3a069a-b7e5-4964-8b94-fdb4f9b13a29,37107945,151,125,26,2
259,4d3a069a-b7e5-4964-8b94-fdb4f9b13a29,37107945,146,142,-4,3
259,4d3a069a-b7e5-4964-8b94-fdb4f9b13a29,37107945,199,154,45,4
259,4d3a069a-b7e5-4964-8b94-fdb4f9b13a29,37107945,310,200,110,5
259,4d3a069a-b7e5-4964-8b94-fdb4f9b13a29,37107945,327,311,16,6
259,4d3a069a-b7e5-4964-8b94-fdb4f9b13a29,37107945,530,338,192,7
259,4d3a069a-b7e5-4964-8b94-fdb4f9b13a29,37107945,661,533,128,8
259,4d3a069a-b7e5-4964-8b94-fdb4f9b13a29,37107945,734,698,36,9
259,4d3a069a-b7e5-4964-8b94-fdb4f9b13a29,37109807,41,4,37,0
259,4d3a069a-b7e5-4964-8b94-fdb4f9b13a29,37109807,225,46,179,1
259,4d3a069a-b7e5-4964-8b94-fdb4f9b13a29,37109807,230,219,-11,2
259,4d3a069a-b7e5-4964-8b94-fdb4f9b13a29,37109807,226,226,0,3
259,4d3a069a-b7e5-4964-8b94-fdb4f9b13a29,37109807,350,233,117,4
259,4d3a069a-b7e5-4964-8b94-fdb4f9b13a29,37109807,1277,350,927,5
259,4d3a069a-b7e5-4964-8b94-fdb4f9b13a29,37109807,1270,1242,-28,6
259,4d3a069a-b7e5-4964-8b94-fdb4f9b13a29,37109807,1221,1085,-136,7
259,4d3a069a-b7e5-4964-8b94-fdb4f9b13a29,37109807,1081,1048,-33,8
259,4d3a069a-b7e5-4964-8b94-fdb4f9b13a29,37109807,1096,1061,35,15
259,4d3a069a-b7e5-4964-8b94-fdb4f9b13a29,37109807,1384,1100,284,18
259,4d3a069a-b7e5-4964-8b94-fdb4f9b13a29,37109807,1387,1381,6,19
259,4d3a069a-b7e5-4964-8b94-fdb4f9b13a29,37109807,1489,1391,98,24
259,4d3a069a-b7e5-4964-8b94-fdb4f9b13a29,37109807,1494,1488,6,25
259,82757cc2-2141-4796-be3d-95eaac2e43ed,37232170,58,4,54,0
259,82757cc2-2141-4796-be3d-95eaac2e43ed,37232170,146,61,85,7
259,82757cc2-2141-4796-be3d-95eaac2e43ed,37232170,263,147,116,8
259,82757cc2-2141-4796-be3d-95eaac2e43ed,37232170,324,267,57,9
259,82757cc2-2141-4796-be3d-95eaac2e43ed,37232170,401,331,70,10
259,82757cc2-2141-4796-be3d-95eaac2e43ed,37232170,720,409,311,11
259,82757cc2-2141-4796-be3d-95eaac2e43ed,37232170,762,728,34,12
259,82757cc2-2141-4796-be3d-95eaac2e43ed,37232170,813,763,50,13
259,82757cc2-2141-4796-be3d-95eaac2e43ed,37232170,829,814,15,14
259,82757cc2-2141-4796-be3d-95eaac2e43ed,37232170,919,831,88,16
259,82757cc2-2141-4796-be3d-95eaac2e43ed,37232170,1995,938,1057,17
259,82757cc2-2141-4796-be3d-95eaac2e43ed,37237513,34,2,32,0
259,82757cc2-2141-4796-be3d-95eaac2e43ed,37237513,269,46,223,1
259,82757cc2-2141-4796-be3d-95eaac2e43ed,37237513,281,271,10,2
259,82757cc2-2141-4796-be3d-95eaac2e43ed,37237513,815,286,529,4
259,82757cc2-2141-4796-be3d-95eaac2e43ed,37237513,869,838,31,5
259,82757cc2-2141-4796-be3d-95eaac2e43ed,37239677,224,3,221,0
259,82757cc2-2141-4796-be3d-95eaac2e43ed,37239677,241,229,12,1
259,82757cc2-2141-4796-be3d-95eaac2e43ed,37239677,720,296,424,7
259,82757cc2-2141-4796-be3d-95eaac2e43ed,37239677,1186,797,389,8
259,82757cc2-2141-4796-be3d-95eaac2e43ed,37239677,1292,1210,82,14
259,82757cc2-2141-4796-be3d-95eaac2e43ed,37239683,28,3,25,0
267,2cd2f888-7c4c-4012-8477-eb724cea0809,37265840,2538,26,2512,0
267,2cd2f888-7c4c-4012-8477-eb724cea0809,37265840,2824,2566,258,1
267,2cd2f888-7c4c-4012-8477-eb724cea0809,37265840,4128,2882,1246,2
267,2cd2f888-7c4c-4012-8477-eb724cea0809,37265840,4085,3484,-601,4
267,2cd2f888-7c4c-4012-8477-eb724cea0809,37265840,3482,3468,-14,5
267,2cd2f888-7c4c-4012-8477-eb724cea0809,37265840,3664,3477,187,27
267,2cd2f888-7c4c-4012-8477-eb724cea0809,37265840,3774,3666,108,28
267,2cd2f888-7c4c-4012-8477-eb724cea0809,37265840,3901,3784,117,33
267,2cd2f888-7c4c-4012-8477-eb724cea0809,37265840,4091,3910,181,37
267,2cd2f888-7c4c-4012-8477-eb724cea0809,37265840,4093,4092,1,38
267,2cd2f888-7c4c-4012-8477-eb724cea0809,37265840,4128,4103,25,39
267,2cd2f888-7c4c-4012-8477-eb724cea0809,37265840,4104,1595,-2509,40
267,2cd2f888-7c4c-4012-8477-eb724cea0809,37265840,1592,0,-1592,41
267,2cd2f888-7c4c-4012-8477-eb724cea0809,37265840,566,11,555,44
267,2cd2f888-7c4c-4012-8477-eb724cea0809,37266075,481,16,465,0
267,2cd2f888-7c4c-4012-8477-eb724cea0809,37266075,978,491,487,1
267,2cd2f888-7c4c-4012-8477-eb724cea0809,37266075,1034,979,55,2
267,2cd2f888-7c4c-4012-8477-eb724cea0809,37266075,1404,1042,362,10
267,2cd2f888-7c4c-4012-8477-eb724cea0809,37266075,1829,1408,421,11
267,2cd2f888-7c4c-4012-8477-eb724cea0809,37266075,1904,1835,69,12
267,2cd2f888-7c4c-4012-8477-eb724cea0809,37266075,1895,1895,0,14
267,2cd2f888-7c4c-4012-8477-eb724cea0809,37266075,2197,1903,294,15
267,2cd2f888-7c4c-4012-8477-eb724cea0809,37266075,2381,2200,181,16
267,2cd2f888-7c4c-4012-8477-eb724cea0809,37266075,2565,2392,173,24
267,2cd2f888-7c4c-4012-8477-eb724cea0809,37266075,2579,2567,12,25
267,2cd2f888-7c4c-4012-8477-eb724cea0809,37266075,2695,2581,114,26
267,2cd2f888-7c4c-4012-8477-eb724cea0809,37266075,2904,2700,204,32
267,2cd2f888-7c4c-4012-8477-eb724cea0809,37266075,2904,2903,1,34
267,2cd2f888-7c4c-4012-8477-eb724cea0809,37266075,2798,863,-1935,36
267,2cd2f888-7c4c-4012-8477-eb724cea0809,37266075,842,138,-704,37
267,e7dec2c6-c445-4cbb-ba16-868b36bebbf6,37283869,308,2,306,0
267,e7dec2c6-c445-4cbb-ba16-868b36bebbf6,37283869,530,354,176,1
267,e7dec2c6-c445-4cbb-ba16-868b36bebbf6,37283869,1199,546,653,3
267,e7dec2c6-c445-4cbb-ba16-868b36bebbf6,37283869,1557,1201,356,4
267,e7dec2c6-c445-4cbb-ba16-868b36bebbf6,37283869,1740,1558,182,5
267,e7dec2c6-c445-4cbb-ba16-868b36bebbf6,37283869,2275,1772,503,8
267,e7dec2c6-c445-4cbb-ba16-868b36bebbf6,37283869,3493,2318,1175,10
267,e7dec2c6-c445-4cbb-ba16-868b36bebbf6,37283869,4092,3561,531,11
267,e7dec2c6-c445-4cbb-ba16-868b36bebbf6,37283869,5101,4146,955,12
267,e7dec2c6-c445-4cbb-ba16-868b36bebbf6,37283869,5727,5102,625,13
267,e7dec2c6-c445-4cbb-ba16-868b36bebbf6,37283869,6783,5812,971,14
267,e7dec2c6-c445-4cbb-ba16-868b36bebbf6,37283869,7429,6808,621,15
267,e7dec2c6-c445-4cbb-ba16-868b36bebbf6,37283869,7648,7430,218,17
267,e7dec2c6-c445-4cbb-ba16-868b36bebbf6,37283869,8512,7656,856,18
267,e7dec2c6-c445-4cbb-ba16-868b36bebbf6,37283869,8695,8535,160,19
267,e7dec2c6-c445-4cbb-ba16-868b36bebbf6,37283869,8972,8703,269,26
267,e7dec2c6-c445-4cbb-ba16-868b36bebbf6,37283869,10565,9006,1559,27
267,e7dec2c6-c445-4cbb-ba16-868b36bebbf6,37283869,12327,10574,1753,28
267,e7dec2c6-c445-4cbb-ba16-868b36bebbf6,37283869,12331,0,-12331,29
267,e7dec2c6-c445-4cbb-ba16-868b36bebbf6,37284033,115,13,102,0
267,e7dec2c6-c445-4cbb-ba16-868b36bebbf6,37284033,288,118,170,1
267,e7dec2c6-c445-4cbb-ba16-868b36bebbf6,37284033,382,289,93,2
267,e7dec2c6-c445-4cbb-ba16-868b36bebbf6,37284033,419,384,35,3
267,e7dec2c6-c445-4cbb-ba16-868b36bebbf6,37284033,489,420,69,4
267,e7dec2c6-c445-4cbb-ba16-868b36bebbf6,37284033,663,490,173,5
267,e7dec2c6-c445-4cbb-ba16-868b36bebbf6,37284033,709,671,38,6
267,db9b32a3-0a9d-4443-97d9-18f1b639d2c2,37312225,300,33,267,0
267,db9b32a3-0a9d-4443-97d9-18f1b639d2c2,37312225,434,327,107,1
267,db9b32a3-0a9d-4443-97d9-18f1b639d2c2,37312225,576,421,155,2
267,db9b32a3-0a9d-4443-97d9-18f1b639d2c2,37312225,695,586,109,3
267,db9b32a3-0a9d-4443-97d9-18f1b639d2c2,37312225,934,702,232,4
267,db9b32a3-0a9d-4443-97d9-18f1b639d2c2,37312225,1033,940,93,5
267,db9b32a3-0a9d-4443-97d9-18f1b639d2c2,37312225,1142,1035,107,6
267,db9b32a3-0a9d-4443-97d9-18f1b639d2c2,37312225,1147,1143,4,7
267,db9b32a3-0a9d-4443-97d9-18f1b639d2c2,37312225,1526,1148,378,8
267,db9b32a3-0a9d-4443-97d9-18f1b639d2c2,37312225,1596,1528,68,9
267,db9b32a3-0a9d-4443-97d9-18f1b639d2c2,37312225,2125,1598,527,10
267,db9b32a3-0a9d-4443-97d9-18f1b639d2c2,37312225,2327,2132,195,13
267,db9b32a3-0a9d-4443-97d9-18f1b639d2c2,37312225,2382,2339,43,14
267,db9b32a3-0a9d-4443-97d9-18f1b639d2c2,37312225,2542,2384,158,15
267,db9b32a3-0a9d-4443-97d9-18f1b639d2c2,37312225,3446,2545,901,16
267,db9b32a3-0a9d-4443-97d9-18f1b639d2c2,37312225,3600,3461,139,17
267,db9b32a3-0a9d-4443-97d9-18f1b639d2c2,37312225,3592,646,-2946,18
267,db9b32a3-0a9d-4443-97d9-18f1b639d2c2,37312225,626,480,-146,19
267,db9b32a3-0a9d-4443-97d9-18f1b639d2c2,37322599,55,4,51,0
267,db9b32a3-0a9d-4443-97d9-18f1b639d2c2,37322599,143,57,86,1
267,db9b32a3-0a9d-4443-97d9-18f1b639d2c2,37322599,185,145,40,2
267,db9b32a3-0a9d-4443-97d9-18f1b639d2c2,37322599,414,186,228,3
267,db9b32a3-0a9d-4443-97d9-18f1b639d2c2,37322599,511,417,94,4
267,db9b32a3-0a9d-4443-97d9-18f1b639d2c2,37322599,713,512,201,5
267,db9b32a3-0a9d-4443-97d9-18f1b639d2c2,37322599,755,724,31,6
267,db9b32a3-0a9d-4443-97d9-18f1b639d2c2,37322599,814,758,56,7
267,db9b32a3-0a9d-4443-97d9-18f1b639d2c2,37322599,998,815,183,8
267,db9b32a3-0a9d-4443-97d9-18f1b639d2c2,37322599,1346,1010,336,9
267,db9b32a3-0a9d-4443-97d9-18f1b639d2c2,37322599,1456,1347,109,10
267,db9b32a3-0a9d-4443-97d9-18f1b639d2c2,37322599,1817,1466,351,11
267,db9b32a3-0a9d-4443-97d9-18f1b639d2c2,37322599,1932,1818,114,12
267,db9b32a3-0a9d-4443-97d9-18f1b639d2c2,37322599,1929,1922,-7,18
267,db9b32a3-0a9d-4443-97d9-18f1b639d2c2,37322599,1932,1932,0,20
267,f5f71647-a1b0-46fb-a112-0ff452e5fc93,37329191,97,7,90,0
267,f5f71647-a1b0-46fb-a112-0ff452e5fc93,37329191,573,124,449,1
267,f5f71647-a1b0-46fb-a112-0ff452e5fc93,37329191,752,591,161,2
267,f5f71647-a1b0-46fb-a112-0ff452e5fc93,37329191,2691,755,1936,12
267,f5f71647-a1b0-46fb-a112-0ff452e5fc93,37329191,2808,2714,94,13
267,f5f71647-a1b0-46fb-a112-0ff452e5fc93,37329191,2802,2744,-58,14
267,f5f71647-a1b0-46fb-a112-0ff452e5fc93,37329191,2733,2494,-239,15
267,f5f71647-a1b0-46fb-a112-0ff452e5fc93,37329191,2493,2487,-6,16
267,f5f71647-a1b0-46fb-a112-0ff452e5fc93,37329191,2465,2094,-371,18
267,f5f71647-a1b0-46fb-a112-0ff452e5fc93,37329191,2091,2080,-11,19
267,f5f71647-a1b0-46fb-a112-0ff452e5fc93,37329191,2561,2083,478,24
267,f5f71647-a1b0-46fb-a112-0ff452e5fc93,37329191,2569,2564,5,25
267,f5f71647-a1b0-46fb-a112-0ff452e5fc93,37329191,2808,2591,217,30
267,f5f71647-a1b0-46fb-a112-0ff452e5fc93,37329191,2808,2807,1,35
267,f5f71647-a1b0-46fb-a112-0ff452e5fc93,37329191,2808,2807,1,38
267,f5f71647-a1b0-46fb-a112-0ff452e5fc93,37329191,2806,2787,-19,39
267,f5f71647-a1b0-46fb-a112-0ff452e5fc93,37329191,2808,2806,2,40
268,d9eb0cea-94da-4fe3-8262-47bf40ebf89b,37314230,92,14,78,0
268,d9eb0cea-94da-4fe3-8262-47bf40ebf89b,37314230,450,122,328,1
268,d9eb0cea-94da-4fe3-8262-47bf40ebf89b,37314230,450,369,81,23
263,6970301e-0799-49ef-b019-a06e3426a117,37356873,582,25,557,0
263,6970301e-0799-49ef-b019-a06e3426a117,37356873,491,84,-407,1
263,6970301e-0799-49ef-b019-a06e3426a117,37356873,37,0,-37,2
263,6970301e-0799-49ef-b019-a06e3426a117,37356873,884,146,738,3
263,6970301e-0799-49ef-b019-a06e3426a117,37356873,1839,916,923,4
263,6970301e-0799-49ef-b019-a06e3426a117,37356873,1840,1840,0,5
263,6970301e-0799-49ef-b019-a06e3426a117,37352326,851,15,836,0
263,6970301e-0799-49ef-b019-a06e3426a117,37352326,1097,881,216,1
263,6970301e-0799-49ef-b019-a06e3426a117,37352326,1404,1229,175,2
263,6970301e-0799-49ef-b019-a06e3426a117,37352326,3506,1412,2094,7
263,6970301e-0799-49ef-b019-a06e3426a117,37352326,3477,2761,-716,8
263,6970301e-0799-49ef-b019-a06e3426a117,37352326,3162,2782,380,10
263,6970301e-0799-49ef-b019-a06e3426a117,37352326,3291,3193,98,11
263,6970301e-0799-49ef-b019-a06e3426a117,37352326,3716,3356,360,16
263,6970301e-0799-49ef-b019-a06e3426a117,37352326,3935,3726,209,18
263,6970301e-0799-49ef-b019-a06e3426a117,37352326,4178,3949,229,20
263,6970301e-0799-49ef-b019-a06e3426a117,37352326,4869,4205,664,22
263,6970301e-0799-49ef-b019-a06e3426a117,37352326,5438,4886,552,23
263,6970301e-0799-49ef-b019-a06e3426a117,37352326,6128,5441,687,24
263,6970301e-0799-49ef-b019-a06e3426a117,37352326,8351,6129,2222,25
263,6970301e-0799-49ef-b019-a06e3426a117,37352326,10409,8354,2055,26
263,6970301e-0799-49ef-b019-a06e3426a117,37352326,10549,10426,123,27
125,688f0ba0-e3e8-40b2-b1fc-e8547e480fac,37351342,513,6,507,0
125,688f0ba0-e3e8-40b2-b1fc-e8547e480fac,37351342,526,316,-210,1
125,688f0ba0-e3e8-40b2-b1fc-e8547e480fac,37351342,345,342,-3,2
125,688f0ba0-e3e8-40b2-b1fc-e8547e480fac,37351342,548,359,189,7
125,688f0ba0-e3e8-40b2-b1fc-e8547e480fac,37351342,4356,572,3784,8
125,688f0ba0-e3e8-40b2-b1fc-e8547e480fac,37351342,4801,2683,-2118,9
125,688f0ba0-e3e8-40b2-b1fc-e8547e480fac,37351342,2882,2734,148,10
125,688f0ba0-e3e8-40b2-b1fc-e8547e480fac,37351342,3488,2937,551,11
125,688f0ba0-e3e8-40b2-b1fc-e8547e480fac,37357574,610,14,596,0
267,4c07055b-1392-4fd9-9778-5f5920364123,37387162,94,5,89,0
267,4c07055b-1392-4fd9-9778-5f5920364123,37387162,851,99,752,1
267,4c07055b-1392-4fd9-9778-5f5920364123,37387162,930,857,73,2
267,4c07055b-1392-4fd9-9778-5f5920364123,37387162,1004,932,72,3
267,4c07055b-1392-4fd9-9778-5f5920364123,37387162,1062,1006,56,4
267,4c07055b-1392-4fd9-9778-5f5920364123,37387162,1411,1068,343,6
267,4c07055b-1392-4fd9-9778-5f5920364123,37387162,2194,1413,781,8
267,4c07055b-1392-4fd9-9778-5f5920364123,37387162,2234,2201,33,9
267,4c07055b-1392-4fd9-9778-5f5920364123,37387162,2826,2237,589,10
267,4c07055b-1392-4fd9-9778-5f5920364123,37387162,4318,2828,1490,11
267,4c07055b-1392-4fd9-9778-5f5920364123,37387162,5620,4326,1294,12
267,4c07055b-1392-4fd9-9778-5f5920364123,37381477,346,18,328,0
267,4c07055b-1392-4fd9-9778-5f5920364123,37381477,350,348,2,1
267,4c07055b-1392-4fd9-9778-5f5920364123,37381477,586,364,222,8
267,4c07055b-1392-4fd9-9778-5f5920364123,37381477,628,590,38,9
267,4c07055b-1392-4fd9-9778-5f5920364123,37381477,667,635,32,14
267,4c07055b-1392-4fd9-9778-5f5920364123,37381477,884,669,215,15
267,4c07055b-1392-4fd9-9778-5f5920364123,37381477,1170,887,283,16
267,4c07055b-1392-4fd9-9778-5f5920364123,37381477,1178,1173,5,17
267,4c07055b-1392-4fd9-9778-5f5920364123,37381477,1390,1182,208,18
267,4c07055b-1392-4fd9-9778-5f5920364123,37381477,1440,1391,49,19
267,4c07055b-1392-4fd9-9778-5f5920364123,37381477,1535,1452,83,24
267,4c07055b-1392-4fd9-9778-5f5920364123,37381477,1865,1548,317,25
267,4c07055b-1392-4fd9-9778-5f5920364123,37381477,2163,1881,282,26
267,4c07055b-1392-4fd9-9778-5f5920364123,37381477,3661,2166,1495,27
267,4c07055b-1392-4fd9-9778-5f5920364123,37381477,3897,3687,210,28
267,4c07055b-1392-4fd9-9778-5f5920364123,37381477,3931,3900,31,33
267,4c07055b-1392-4fd9-9778-5f5920364123,37381477,3986,3932,54,34
267,4c07055b-1392-4fd9-9778-5f5920364123,37381477,5493,3991,1502,35
267,4c07055b-1392-4fd9-9778-5f5920364123,37381477,6264,5517,747,36
259,58fb0ded-358a-4ed6-acce-152b70976206,37436676,55,1,54,0
259,58fb0ded-358a-4ed6-acce-152b70976206,37436676,65,57,8,1
259,58fb0ded-358a-4ed6-acce-152b70976206,37436676,139,73,66,9
259,58fb0ded-358a-4ed6-acce-152b70976206,37436676,180,147,33,12
259,58fb0ded-358a-4ed6-acce-152b70976206,37436676,191,181,10,13
259,58fb0ded-358a-4ed6-acce-152b70976206,37436676,199,194,5,15
259,58fb0ded-358a-4ed6-acce-152b70976206,37436676,220,200,20,16
259,58fb0ded-358a-4ed6-acce-152b70976206,37436676,248,221,27,17
259,58fb0ded-358a-4ed6-acce-152b70976206,37436676,1084,252,832,19
259,58fb0ded-358a-4ed6-acce-152b70976206,37436676,1065,1063,-2,20
259,58fb0ded-358a-4ed6-acce-152b70976206,37436676,1065,1063,2,20
259,58fb0ded-358a-4ed6-acce-152b70976206,37436676,1115,1072,43,28
259,58fb0ded-358a-4ed6-acce-152b70976206,37436676,1185,1118,67,29
259,58fb0ded-358a-4ed6-acce-152b70976206,37436676,1273,1273,0,32
259,58fb0ded-358a-4ed6-acce-152b70976206,37436676,1316,1285,31,33
259,58fb0ded-358a-4ed6-acce-152b70976206,37436676,1363,1323,40,34
259,58fb0ded-358a-4ed6-acce-152b70976206,37436676,1390,1364,26,36
259,58fb0ded-358a-4ed6-acce-152b70976206,37436676,1432,1392,40,37
259,58fb0ded-358a-4ed6-acce-152b70976206,37436676,1574,1434,140,38
259,58fb0ded-358a-4ed6-acce-152b70976206,37436676,2055,1579,476,40
259,58fb0ded-358a-4ed6-acce-152b70976206,37436676,2360,2079,281,41
259,58fb0ded-358a-4ed6-acce-152b70976206,37436676,2443,2362,81,52
259,58fb0ded-358a-4ed6-acce-152b70976206,37436676,2448,2444,4,53
259,58fb0ded-358a-4ed6-acce-152b70976206,37436676,0,0,0,55
259,58fb0ded-358a-4ed6-acce-152b70976206,37436946,155,9,146,0
259,58fb0ded-358a-4ed6-acce-152b70976206,37436946,296,160,136,1
259,58fb0ded-358a-4ed6-acce-152b70976206,37436946,292,104,-188,5
259,58fb0ded-358a-4ed6-acce-152b70976206,37436946,266,106,160,6
259,58fb0ded-358a-4ed6-acce-152b70976206,37436946,290,265,25,7
259,58fb0ded-358a-4ed6-acce-152b70976206,37436946,407,292,115,8
259,58fb0ded-358a-4ed6-acce-152b70976206,37436946,592,408,184,9
259,58fb0ded-358a-4ed6-acce-152b70976206,37436946,642,598,44,10
259,58fb0ded-358a-4ed6-acce-152b70976206,37436946,1008,643,365,11
259,58fb0ded-358a-4ed6-acce-152b70976206,37436946,1020,1011,9,17
259,58fb0ded-358a-4ed6-acce-152b70976206,37436946,1080,1022,58,18
259,58fb0ded-358a-4ed6-acce-152b70976206,37436946,1146,1092,54,19
259,58fb0ded-358a-4ed6-acce-152b70976206,37436946,1230,1147,83,20
259,58fb0ded-358a-4ed6-acce-152b70976206,37436946,1254,1238,16,21
259,58fb0ded-358a-4ed6-acce-152b70976206,37437651,46,4,42,0
259,58fb0ded-358a-4ed6-acce-152b70976206,37437651,102,47,55,1
259,58fb0ded-358a-4ed6-acce-152b70976206,37437651,115,103,12,2
259,58fb0ded-358a-4ed6-acce-152b70976206,37437651,181,116,65,6
259,58fb0ded-358a-4ed6-acce-152b70976206,37437651,485,184,301,7
259,58fb0ded-358a-4ed6-acce-152b70976206,37437651,647,507,140,8
259,58fb0ded-358a-4ed6-acce-152b70976206,37437651,742,668,74,9
259,58fb0ded-358a-4ed6-acce-152b70976206,37437651,1475,762,713,10
259,58fb0ded-358a-4ed6-acce-152b70976206,37437651,1486,1486,0,18
259,58fb0ded-358a-4ed6-acce-152b70976206,37437651,2337,1521,816,19
259,58fb0ded-358a-4ed6-acce-152b70976206,37437651,2494,2346,148,22
259,c6ac2400-b8c2-4545-ac34-67e6e6e5db13,37451237,17,7,10,0
259,c6ac2400-b8c2-4545-ac34-67e6e6e5db13,37451237,140,34,106,1
259,c6ac2400-b8c2-4545-ac34-67e6e6e5db13,37451237,151,141,10,2
259,c6ac2400-b8c2-4545-ac34-67e6e6e5db13,37451237,193,152,41,3
259,c6ac2400-b8c2-4545-ac34-67e6e6e5db13,37451237,203,199,4,4
259,c6ac2400-b8c2-4545-ac34-67e6e6e5db13,37451237,242,239,3,5
259,c6ac2400-b8c2-4545-ac34-67e6e6e5db13,37451237,313,247,66,6
259,c6ac2400-b8c2-4545-ac34-67e6e6e5db13,37451237,444,315,129,7
259,c6ac2400-b8c2-4545-ac34-67e6e6e5db13,37451237,643,448,195,8
259,c6ac2400-b8c2-4545-ac34-67e6e6e5db13,37451237,859,651,208,9
259,c6ac2400-b8c2-4545-ac34-67e6e6e5db13,37451237,1014,860,154,10
259,c6ac2400-b8c2-4545-ac34-67e6e6e5db13,37451237,1145,1017,128,12
259,c6ac2400-b8c2-4545-ac34-67e6e6e5db13,37451237,1404,1155,249,13
259,c6ac2400-b8c2-4545-ac34-67e6e6e5db13,37451237,1410,1402,8,14
259,c6ac2400-b8c2-4545-ac34-67e6e6e5db13,37451237,1417,1417,0,18
259,c6ac2400-b8c2-4545-ac34-67e6e6e5db13,37451237,1541,1440,101,19
259,c6ac2400-b8c2-4545-ac34-67e6e6e5db13,37451237,1678,1543,135,21
259,c6ac2400-b8c2-4545-ac34-67e6e6e5db13,37451237,1761,1681,80,22
259,c6ac2400-b8c2-4545-ac34-67e6e6e5db13,37451237,1826,1763,63,23
259,c6ac2400-b8c2-4545-ac34-67e6e6e5db13,37451237,2196,1840,356,24
259,147b53b5-bffe-4cff-9b03-0b051fb32de7,37491982,39,8,31,0
259,147b53b5-bffe-4cff-9b03-0b051fb32de7,37491982,85,38,47,11
259,147b53b5-bffe-4cff-9b03-0b051fb32de7,37491982,166,101,65,12
259,147b53b5-bffe-4cff-9b03-0b051fb32de7,37491982,558,168,390,13
259,147b53b5-bffe-4cff-9b03-0b051fb32de7,37491982,915,571,344,14
259,147b53b5-bffe-4cff-9b03-0b051fb32de7,37491982,1296,934,362,15
259,147b53b5-bffe-4cff-9b03-0b051fb32de7,37491982,1321,1288,-33,16
259,147b53b5-bffe-4cff-9b03-0b051fb32de7,37491982,1287,1264,-23,17
259,147b53b5-bffe-4cff-9b03-0b051fb32de7,37491982,1281,1269,12,20
259,147b53b5-bffe-4cff-9b03-0b051fb32de7,37491982,1286,1285,1,21
259,147b53b5-bffe-4cff-9b03-0b051fb32de7,37491982,1286,1285,-1,21
259,147b53b5-bffe-4cff-9b03-0b051fb32de7,37491982,1580,1389,191,1144
283,29bf6b2c-4106-4b9b-83a9-dcef4edef62c,37537258,125,8,117,0
283,29bf6b2c-4106-4b9b-83a9-dcef4edef62c,37537258,151,129,22,1
283,29bf6b2c-4106-4b9b-83a9-dcef4edef62c,37537258,491,152,339,2
283,29bf6b2c-4106-4b9b-83a9-dcef4edef62c,37537258,717,501,216,3
283,29bf6b2c-4106-4b9b-83a9-dcef4edef62c,37537258,946,737,209,4
283,29bf6b2c-4106-4b9b-83a9-dcef4edef62c,37537258,1235,960,275,9
283,29bf6b2c-4106-4b9b-83a9-dcef4edef62c,37537258,1312,1242,70,10
283,29bf6b2c-4106-4b9b-83a9-dcef4edef62c,37537258,1310,1304,-6,13
283,29bf6b2c-4106-4b9b-83a9-dcef4edef62c,37537258,1303,1214,-89,17
283,29bf6b2c-4106-4b9b-83a9-dcef4edef62c,37537258,1312,1252,60,24
298,b2b53d95-02b7-4702-a95f-a26c8f54b620,37548668,137,4,133,0
298,b2b53d95-02b7-4702-a95f-a26c8f54b620,37548668,385,150,235,1
298,b2b53d95-02b7-4702-a95f-a26c8f54b620,37548668,876,394,482,2
298,b2b53d95-02b7-4702-a95f-a26c8f54b620,37548668,1109,883,226,3
298,b2b53d95-02b7-4702-a95f-a26c8f54b620,37548668,3613,1118,2495,4
298,b2b53d95-02b7-4702-a95f-a26c8f54b620,37548668,6703,3711,2992,5
298,b2b53d95-02b7-4702-a95f-a26c8f54b620,37548668,6808,6786,22,6
299,c21c569f-6d83-4b82-be73-22cf0a997297,37518681,725,16,709,0
299,c21c569f-6d83-4b82-be73-22cf0a997297,37518681,1958,755,1203,1
299,c21c569f-6d83-4b82-be73-22cf0a997297,37518681,1943,0,-1943,2
301,ea42cbfb-919e-4a66-ad37-f9a40c842fd0,37568540,1,1,0,0
301,ea42cbfb-919e-4a66-ad37-f9a40c842fd0,37568540,609,22,587,1
301,ea42cbfb-919e-4a66-ad37-f9a40c842fd0,37568540,1027,612,415,2
301,ea42cbfb-919e-4a66-ad37-f9a40c842fd0,37568540,978,0,-978,5
301,ea42cbfb-919e-4a66-ad37-f9a40c842fd0,37568540,731,29,702,7
301,ea42cbfb-919e-4a66-ad37-f9a40c842fd0,37568540,1075,737,338,8
301,ea42cbfb-919e-4a66-ad37-f9a40c842fd0,37568540,1417,1079,338,17
301,ea42cbfb-919e-4a66-ad37-f9a40c842fd0,37568540,1559,1423,136,18
301,ea42cbfb-919e-4a66-ad37-f9a40c842fd0,37568540,1694,1563,131,20
301,ea42cbfb-919e-4a66-ad37-f9a40c842fd0,37568540,1867,1697,170,21
301,ea42cbfb-919e-4a66-ad37-f9a40c842fd0,37568540,2086,1870,216,22
301,ea42cbfb-919e-4a66-ad37-f9a40c842fd0,37568540,2859,2112,747,27
301,ea42cbfb-919e-4a66-ad37-f9a40c842fd0,37568540,2884,2865,19,28
302,44ccefdc-b913-4c45-b0db-357a13766073,37564020,285,9,276,0
302,44ccefdc-b913-4c45-b0db-357a13766073,37564020,2667,291,2376,1
302,44ccefdc-b913-4c45-b0db-357a13766073,37564020,2605,0,-2605,3
302,44ccefdc-b913-4c45-b0db-357a13766073,37563581,266,13,253,0
302,44ccefdc-b913-4c45-b0db-357a13766073,37563581,312,286,26,1
303,7e3a884b-f64f-43e4-ad2b-7c3390390841,37571694,194,55,139,0
303,7e3a884b-f64f-43e4-ad2b-7c3390390841,37571694,569,221,348,1
303,7e3a884b-f64f-43e4-ad2b-7c3390390841,37571694,675,591,84,2
303,7e3a884b-f64f-43e4-ad2b-7c3390390841,37571694,1110,701,409,3
303,7e3a884b-f64f-43e4-ad2b-7c3390390841,37571694,1116,1110,-6,4
303,7e3a884b-f64f-43e4-ad2b-7c3390390841,37571694,1464,1141,323,5
303,7e3a884b-f64f-43e4-ad2b-7c3390390841,37571694,1629,1500,129,6
303,7e3a884b-f64f-43e4-ad2b-7c3390390841,37568540,372,6,366,0
303,7e3a884b-f64f-43e4-ad2b-7c3390390841,37568540,711,400,311,1
303,7e3a884b-f64f-43e4-ad2b-7c3390390841,37568540,663,343,-320,4
303,7e3a884b-f64f-43e4-ad2b-7c3390390841,37568540,342,341,-1,5
303,7e3a884b-f64f-43e4-ad2b-7c3390390841,37568540,313,71,-242,8
303,7e3a884b-f64f-43e4-ad2b-7c3390390841,37568540,69,0,-69,9
303,7e3a884b-f64f-43e4-ad2b-7c3390390841,37568540,675,29,646,11
303,7e3a884b-f64f-43e4-ad2b-7c3390390841,37568540,768,693,75,12
303,7e3a884b-f64f-43e4-ad2b-7c3390390841,37568540,1100,804,296,14
303,7e3a884b-f64f-43e4-ad2b-7c3390390841,37568540,1282,1108,174,15
303,7e3a884b-f64f-43e4-ad2b-7c3390390841,37568540,1547,1289,258,16
303,7e3a884b-f64f-43e4-ad2b-7c3390390841,37568540,1907,1563,344,18
303,7e3a884b-f64f-43e4-ad2b-7c3390390841,37568540,2110,1920,190,19
303,7e3a884b-f64f-43e4-ad2b-7c3390390841,37568540,2202,2114,88,20
303,7e3a884b-f64f-43e4-ad2b-7c3390390841,37568540,2259,2204,55,21
303,7e3a884b-f64f-43e4-ad2b-7c3390390841,37568540,2276,2270,6,22
303,7e3a884b-f64f-43e4-ad2b-7c3390390841,37568540,2631,2281,350,26
303,7e3a884b-f64f-43e4-ad2b-7c3390390841,37565653,149,10,139,0
303,7e3a884b-f64f-43e4-ad2b-7c3390390841,37565653,295,154,141,1
303,7e3a884b-f64f-43e4-ad2b-7c3390390841,37565653,496,336,160,9
303,7e3a884b-f64f-43e4-ad2b-7c3390390841,37565653,680,530,150,13
303,7e3a884b-f64f-43e4-ad2b-7c3390390841,37565653,1197,702,495,22
303,7e3a884b-f64f-43e4-ad2b-7c3390390841,37565653,1426,1227,199,24
303,7e3a884b-f64f-43e4-ad2b-7c3390390841,37565653,1922,1459,463,25
303,7e3a884b-f64f-43e4-ad2b-7c3390390841,37565653,2088,1946,142,26
303,7e3a884b-f64f-43e4-ad2b-7c3390390841,37565653,2409,2115,294,28
303,7e3a884b-f64f-43e4-ad2b-7c3390390841,37563250,225,15,210,0
303,7e3a884b-f64f-43e4-ad2b-7c3390390841,37563250,334,243,91,1
303,7e3a884b-f64f-43e4-ad2b-7c3390390841,37563250,664,339,325,12
303,7e3a884b-f64f-43e4-ad2b-7c3390390841,37563250,684,669,15,13
303,7e3a884b-f64f-43e4-ad2b-7c3390390841,37563250,1070,708,362,14
303,7e3a884b-f64f-43e4-ad2b-7c3390390841,37563250,1270,1095,175,15
303,7e3a884b-f64f-43e4-ad2b-7c3390390841,37563250,1852,1311,541,19
304,311448ec-24bc-42e0-8c5d-d7d4b1880047,37567866,213,4,209,0
304,311448ec-24bc-42e0-8c5d-d7d4b1880047,37567866,809,239,570,1
304,311448ec-24bc-42e0-8c5d-d7d4b1880047,37567866,1237,823,414,4
304,311448ec-24bc-42e0-8c5d-d7d4b1880047,37567866,1392,1243,149,5
304,311448ec-24bc-42e0-8c5d-d7d4b1880047,37567866,1970,1397,573,8
304,311448ec-24bc-42e0-8c5d-d7d4b1880047,37567866,2537,1982,555,10
304,311448ec-24bc-42e0-8c5d-d7d4b1880047,37567866,3962,2544,1418,11
304,311448ec-24bc-42e0-8c5d-d7d4b1880047,37567866,4176,3992,184,12
302,39da56ce-404f-4f58-b226-04d5bc72dc26,37567866,188,4,184,0
302,39da56ce-404f-4f58-b226-04d5bc72dc26,37567866,694,240,454,3
302,39da56ce-404f-4f58-b226-04d5bc72dc26,37567866,1806,1437,369,6
302,39da56ce-404f-4f58-b226-04d5bc72dc26,37567866,2044,1811,233,7
302,39da56ce-404f-4f58-b226-04d5bc72dc26,37567866,2044,1395,-649,10
304,311448ec-24bc-42e0-8c5d-d7d4b1880047,37566361,984,6,978,0
304,311448ec-24bc-42e0-8c5d-d7d4b1880047,37566361,985,985,0,1
304,311448ec-24bc-42e0-8c5d-d7d4b1880047,37566361,1385,996,389,2
304,311448ec-24bc-42e0-8c5d-d7d4b1880047,37566361,1649,1402,247,3
304,311448ec-24bc-42e0-8c5d-d7d4b1880047,37566361,1716,1660,56,4
304,311448ec-24bc-42e0-8c5d-d7d4b1880047,37566361,1995,1715,280,5
304,311448ec-24bc-42e0-8c5d-d7d4b1880047,37566361,2100,2002,98,6
304,311448ec-24bc-42e0-8c5d-d7d4b1880047,37566361,2277,2107,170,9
304,311448ec-24bc-42e0-8c5d-d7d4b1880047,37566361,2445,2291,154,10
304,311448ec-24bc-42e0-8c5d-d7d4b1880047,37566361,2715,195,2520,12
304,311448ec-24bc-42e0-8c5d-d7d4b1880047,37566361,2837,2726,111,13
304,311448ec-24bc-42e0-8c5d-d7d4b1880047,37566361,2946,701,2245,15
304,311448ec-24bc-42e0-8c5d-d7d4b1880047,37566361,3072,1043,2029,16
304,311448ec-24bc-42e0-8c5d-d7d4b1880047,37566361,3331,0,3331,22
304,311448ec-24bc-42e0-8c5d-d7d4b1880047,37566361,3333,0,3333,23
304,311448ec-24bc-42e0-8c5d-d7d4b1880047,37566361,4042,3337,705,37
304,311448ec-24bc-42e0-8c5d-d7d4b1880047,37566361,4892,4049,843,38
304,311448ec-24bc-42e0-8c5d-d7d4b1880047,37566361,6956,5024,1932,39
304,311448ec-24bc-42e0-8c5d-d7d4b1880047,37574256,824,57,767,0
304,311448ec-24bc-42e0-8c5d-d7d4b1880047,37574256,768,345,-423,34
304,311448ec-24bc-42e0-8c5d-d7d4b1880047,37574256,328,0,-328,35
304,311448ec-24bc-42e0-8c5d-d7d4b1880047,37567402,763,18,745,0
304,311448ec-24bc-42e0-8c5d-d7d4b1880047,37567402,769,765,4,1
304,311448ec-24bc-42e0-8c5d-d7d4b1880047,37567402,1320,772,548,3
304,311448ec-24bc-42e0-8c5d-d7d4b1880047,37567402,1367,1335,32,4
304,311448ec-24bc-42e0-8c5d-d7d4b1880047,37567402,1812,1384,428,18
304,311448ec-24bc-42e0-8c5d-d7d4b1880047,37567402,1828,1820,8,19
304,311448ec-24bc-42e0-8c5d-d7d4b1880047,37567402,2281,1858,423,21
304,311448ec-24bc-42e0-8c5d-d7d4b1880047,37567402,2362,2276,86,23
304,311448ec-24bc-42e0-8c5d-d7d4b1880047,37567402,2753,2411,342,24
304,311448ec-24bc-42e0-8c5d-d7d4b1880047,37567402,3571,2818,753,25
304,311448ec-24bc-42e0-8c5d-d7d4b1880047,37567402,3887,3581,306,26
304,311448ec-24bc-42e0-8c5d-d7d4b1880047,37567402,4431,3926,505,30
304,311448ec-24bc-42e0-8c5d-d7d4b1880047,37567402,4433,4432,1,31
304,311448ec-24bc-42e0-8c5d-d7d4b1880047,37567402,4640,4448,192,34
304,311448ec-24bc-42e0-8c5d-d7d4b1880047,37567402,4888,4662,226,35
304,311448ec-24bc-42e0-8c5d-d7d4b1880047,37567402,93,11,82,64
304,311448ec-24bc-42e0-8c5d-d7d4b1880047,37567402,2652,114,2538,65
304,311448ec-24bc-42e0-8c5d-d7d4b1880047,37567402,3667,0,-3667,66
304,311448ec-24bc-42e0-8c5d-d7d4b1880047,37573938,420,38,382,0
304,311448ec-24bc-42e0-8c5d-d7d4b1880047,37573938,732,448,284,13
304,311448ec-24bc-42e0-8c5d-d7d4b1880047,37573938,1004,758,246,22
304,311448ec-24bc-42e0-8c5d-d7d4b1880047,37573938,1172,1019,153,23
304,311448ec-24bc-42e0-8c5d-d7d4b1880047,37573938,1171,1171,0,42
304,311448ec-24bc-42e0-8c5d-d7d4b1880047,37573938,1172,1172,0,49
304,311448ec-24bc-42e0-8c5d-d7d4b1880047,37573938,1172,1170,2,53
302,cad2ddb1-d460-482d-b1fb-6201f3e958fb,37574974,199,5,194,0
302,cad2ddb1-d460-482d-b1fb-6201f3e958fb,37574974,355,201,154,1
302,cad2ddb1-d460-482d-b1fb-6201f3e958fb,37574974,447,370,77,2
302,cad2ddb1-d460-482d-b1fb-6201f3e958fb,37574974,450,448,2,3
302,cad2ddb1-d460-482d-b1fb-6201f3e958fb,37574974,679,454,225,4
302,cad2ddb1-d460-482d-b1fb-6201f3e958fb,37574974,1082,681,401,5
302,cad2ddb1-d460-482d-b1fb-6201f3e958fb,37574974,1251,1090,161,6
302,cad2ddb1-d460-482d-b1fb-6201f3e958fb,37574974,1529,1254,275,7
302,cad2ddb1-d460-482d-b1fb-6201f3e958fb,37574974,1733,1535,198,8
302,cad2ddb1-d460-482d-b1fb-6201f3e958fb,37574974,1733,1132,-601,10
302,cad2ddb1-d460-482d-b1fb-6201f3e958fb,37574974,997,0,-997,11
302,cad2ddb1-d460-482d-b1fb-6201f3e958fb,37574568,551,24,527,0
302,cad2ddb1-d460-482d-b1fb-6201f3e958fb,37574568,555,552,3,1
302,cad2ddb1-d460-482d-b1fb-6201f3e958fb,37574568,648,557,91,2
302,cad2ddb1-d460-482d-b1fb-6201f3e958fb,37574568,714,649,65,3
302,cad2ddb1-d460-482d-b1fb-6201f3e958fb,37574568,843,716,127,4
302,cad2ddb1-d460-482d-b1fb-6201f3e958fb,37574568,949,844,105,5
302,cad2ddb1-d460-482d-b1fb-6201f3e958fb,37574568,1131,952,179,6
302,cad2ddb1-d460-482d-b1fb-6201f3e958fb,37574568,2377,1143,1234,7
302,cad2ddb1-d460-482d-b1fb-6201f3e958fb,37574568,2377,2376,1,8
304,9d5f18cf-1fb3-4267-9efa-3d59f40e8143,37321656,187,13,174,0
304,9d5f18cf-1fb3-4267-9efa-3d59f40e8143,37321656,1181,212,969,1
304,9d5f18cf-1fb3-4267-9efa-3d59f40e8143,37321656,1295,1199,96,2
304,9d5f18cf-1fb3-4267-9efa-3d59f40e8143,37321656,1579,1530,49,3
304,9d5f18cf-1fb3-4267-9efa-3d59f40e8143,37321656,1742,1584,158,9
304,9d5f18cf-1fb3-4267-9efa-3d59f40e8143,37321656,2062,1752,310,10
304,9d5f18cf-1fb3-4267-9efa-3d59f40e8143,37321656,2099,2063,36,11
304,9d5f18cf-1fb3-4267-9efa-3d59f40e8143,37321656,2740,2347,393,16
303,126b473e-8f70-4777-bac9-d7459f208708,37582558,224,5,219,0
303,126b473e-8f70-4777-bac9-d7459f208708,37582558,384,228,156,1
303,126b473e-8f70-4777-bac9-d7459f208708,37582558,387,386,1,2
303,126b473e-8f70-4777-bac9-d7459f208708,37582558,495,393,102,3
303,126b473e-8f70-4777-bac9-d7459f208708,37582558,495,494,1,4
302,e38c3ba4-9954-4dbb-86e8-6424cf2a74c6,37321656,84,1,83,0
302,e38c3ba4-9954-4dbb-86e8-6424cf2a74c6,37321656,183,85,98,1
302,e38c3ba4-9954-4dbb-86e8-6424cf2a74c6,37321656,366,201,165,6
302,e38c3ba4-9954-4dbb-86e8-6424cf2a74c6,37321656,794,414,380,7
302,e38c3ba4-9954-4dbb-86e8-6424cf2a74c6,37321656,796,796,0,11
302,e38c3ba4-9954-4dbb-86e8-6424cf2a74c6,37321656,875,799,76,12
302,e38c3ba4-9954-4dbb-86e8-6424cf2a74c6,37321656,996,879,117,13
302,e38c3ba4-9954-4dbb-86e8-6424cf2a74c6,37321656,1065,997,68,15
302,e38c3ba4-9954-4dbb-86e8-6424cf2a74c6,37321656,1070,1067,3,16
302,e38c3ba4-9954-4dbb-86e8-6424cf2a74c6,37321656,1370,1071,299,19
302,e38c3ba4-9954-4dbb-86e8-6424cf2a74c6,37321656,1918,1379,539,20
302,e38c3ba4-9954-4dbb-86e8-6424cf2a74c6,37321656,1926,1922,4,21
302,e38c3ba4-9954-4dbb-86e8-6424cf2a74c6,37321656,2210,1937,273,22
302,e38c3ba4-9954-4dbb-86e8-6424cf2a74c6,37321656,3140,2214,926,23
302,e38c3ba4-9954-4dbb-86e8-6424cf2a74c6,37321656,4719,3176,1543,24
302,e38c3ba4-9954-4dbb-86e8-6424cf2a74c6,37321656,6598,4720,1878,25
302,e38c3ba4-9954-4dbb-86e8-6424cf2a74c6,37321656,6892,6734,158,26
302,e38c3ba4-9954-4dbb-86e8-6424cf2a74c6,37573818,3,3,0,0
302,e38c3ba4-9954-4dbb-86e8-6424cf2a74c6,37573818,157,6,151,2
305,5a0922b8-408e-4965-ab7c-25ad606d29a3,37637453,356,3,353,0
305,5a0922b8-408e-4965-ab7c-25ad606d29a3,37637453,546,361,185,1
305,5a0922b8-408e-4965-ab7c-25ad606d29a3,37637453,621,552,69,2
305,5a0922b8-408e-4965-ab7c-25ad606d29a3,37637453,840,631,209,3
305,5a0922b8-408e-4965-ab7c-25ad606d29a3,37637453,931,842,89,4
305,5a0922b8-408e-4965-ab7c-25ad606d29a3,37637453,1132,936,196,7
305,5a0922b8-408e-4965-ab7c-25ad606d29a3,37637453,1132,1131,1,8
305,5a0922b8-408e-4965-ab7c-25ad606d29a3,37637453,1132,1131,-1,8
305,5a0922b8-408e-4965-ab7c-25ad606d29a3,37637453,1132,1131,1,9
305,5a0922b8-408e-4965-ab7c-25ad606d29a3,37637453,1132,1131,-1,9
305,5a0922b8-408e-4965-ab7c-25ad606d29a3,37637453,1132,1131,1,10
305,5a0922b8-408e-4965-ab7c-25ad606d29a3,37637453,1132,1131,1,11
305,5a0922b8-408e-4965-ab7c-25ad606d29a3,37637453,1132,1131,-1,11
305,5a0922b8-408e-4965-ab7c-25ad606d29a3,37637453,1132,1132,0,12
305,5a0922b8-408e-4965-ab7c-25ad606d29a3,37637453,1132,1120,-12,13
305,5a0922b8-408e-4965-ab7c-25ad606d29a3,37637453,1132,983,149,14
305,5a0922b8-408e-4965-ab7c-25ad606d29a3,37637453,1132,1131,1,15
305,5a0922b8-408e-4965-ab7c-25ad606d29a3,37637453,1120,0,-1120,25
305,4e26856a-7c84-441d-9a1d-69215f0b762a,37638631,96,15,81,0
305,4e26856a-7c84-441d-9a1d-69215f0b762a,37638631,95,0,-95,2
305,4e26856a-7c84-441d-9a1d-69215f0b762a,37638631,96,1,95,3
305,4e26856a-7c84-441d-9a1d-69215f0b762a,37638631,90,0,-90,5
303,ebb6b017-839d-4b36-b9de-841f25f3ab06,37855207,514,10,504,0
303,ebb6b017-839d-4b36-b9de-841f25f3ab06,37855207,809,530,279,1
303,ebb6b017-839d-4b36-b9de-841f25f3ab06,37855207,1017,819,198,2
303,ebb6b017-839d-4b36-b9de-841f25f3ab06,37855207,1173,1060,113,34
303,ebb6b017-839d-4b36-b9de-841f25f3ab06,37855207,1951,1196,755,35
303,ebb6b017-839d-4b36-b9de-841f25f3ab06,37855207,2106,1960,146,36
303,ebb6b017-839d-4b36-b9de-841f25f3ab06,37855207,2262,2111,151,37
303,ebb6b017-839d-4b36-b9de-841f25f3ab06,37855207,2406,2273,133,38
303,ebb6b017-839d-4b36-b9de-841f25f3ab06,37855207,2587,2414,173,39
303,ebb6b017-839d-4b36-b9de-841f25f3ab06,37855207,2605,2590,15,40
305,605527d0-a50c-4ce9-b65e-800953575e38,38019771,170,2,168,0
305,605527d0-a50c-4ce9-b65e-800953575e38,38019771,332,177,155,1
305,605527d0-a50c-4ce9-b65e-800953575e38,38019771,472,339,133,2
305,605527d0-a50c-4ce9-b65e-800953575e38,38019771,718,474,244,3
305,605527d0-a50c-4ce9-b65e-800953575e38,38019771,1108,725,383,4
305,605527d0-a50c-4ce9-b65e-800953575e38,38019771,1525,1139,386,5
305,605527d0-a50c-4ce9-b65e-800953575e38,38019771,2136,1542,594,6
305,605527d0-a50c-4ce9-b65e-800953575e38,38019771,4673,2186,2487,7
305,605527d0-a50c-4ce9-b65e-800953575e38,38019771,8020,4699,3321,8
305,605527d0-a50c-4ce9-b65e-800953575e38,38019771,8016,3664,-4352,10
305,605527d0-a50c-4ce9-b65e-800953575e38,38019771,3563,1159,-2404,11
305,87afaed8-2475-485a-8c72-74d62926a51c,38090977,1146,7,1139,0
305,87afaed8-2475-485a-8c72-74d62926a51c,38090977,3241,1149,2092,1
305,87afaed8-2475-485a-8c72-74d62926a51c,38090977,7448,3244,4204,2
305,87afaed8-2475-485a-8c72-74d62926a51c,38090977,13492,7556,5936,3
305,87afaed8-2475-485a-8c72-74d62926a51c,38090977,13439,6101,-7338,6
305,87afaed8-2475-485a-8c72-74d62926a51c,38090977,5935,0,-5935,7
305,87afaed8-2475-485a-8c72-74d62926a51c,38090977,2765,30,2735,8
305,87afaed8-2475-485a-8c72-74d62926a51c,38090977,2315,0,-2315,9
310,59045233-b688-41e1-9612-9960261373e5,39136902,834,10,824,0
310,59045233-b688-41e1-9612-9960261373e5,39136902,1329,878,451,1
310,59045233-b688-41e1-9612-9960261373e5,39136902,1885,1332,553,2
310,59045233-b688-41e1-9612-9960261373e5,39136902,3550,1925,1625,3
310,59045233-b688-41e1-9612-9960261373e5,39136902,6642,3588,3054,4
310,59045233-b688-41e1-9612-9960261373e5,39136902,7191,6707,484,5
309,c714781a-17c9-41a5-a1a2-dba4a0ddf40e,39202936,316,2,314,0
309,c714781a-17c9-41a5-a1a2-dba4a0ddf40e,39202936,580,334,246,1
309,c714781a-17c9-41a5-a1a2-dba4a0ddf40e,39202936,697,581,116,2
309,c714781a-17c9-41a5-a1a2-dba4a0ddf40e,39202936,1220,711,509,23
309,c714781a-17c9-41a5-a1a2-dba4a0ddf40e,39202936,1440,1238,202,24
309,c714781a-17c9-41a5-a1a2-dba4a0ddf40e,39202936,1456,1443,13,25
309,c714781a-17c9-41a5-a1a2-dba4a0ddf40e,39202936,1800,1458,342,47
309,c714781a-17c9-41a5-a1a2-dba4a0ddf40e,39202936,1962,1806,156,48
309,c714781a-17c9-41a5-a1a2-dba4a0ddf40e,39202936,2359,1987,372,73
309,c714781a-17c9-41a5-a1a2-dba4a0ddf40e,39202936,2507,2375,132,74
309,c714781a-17c9-41a5-a1a2-dba4a0ddf40e,39202936,3322,2520,802,78
309,c714781a-17c9-41a5-a1a2-dba4a0ddf40e,39202936,3596,3331,265,89
309,c714781a-17c9-41a5-a1a2-dba4a0ddf40e,39202936,3653,3597,56,90
309,c714781a-17c9-41a5-a1a2-dba4a0ddf40e,39202936,3845,3658,187,91
309,c714781a-17c9-41a5-a1a2-dba4a0ddf40e,39202936,3983,3847,136,92
328,de2f2a02-62b7-4346-b92a-13b00ce79e23,40247178,974,49,925,0
328,de2f2a02-62b7-4346-b92a-13b00ce79e23,40247178,1410,998,412,1
328,de2f2a02-62b7-4346-b92a-13b00ce79e23,40247178,1538,1254,284,2
328,de2f2a02-62b7-4346-b92a-13b00ce79e23,40247178,1534,1393,-141,3
328,de2f2a02-62b7-4346-b92a-13b00ce79e23,40247178,1978,1374,604,4
328,de2f2a02-62b7-4346-b92a-13b00ce79e23,40247178,2172,1980,192,5
328,de2f2a02-62b7-4346-b92a-13b00ce79e23,40247178,2720,2109,611,6
328,de2f2a02-62b7-4346-b92a-13b00ce79e23,40247178,3484,2738,746,7
328,de2f2a02-62b7-4346-b92a-13b00ce79e23,40247178,3650,3504,146,8
328,de2f2a02-62b7-4346-b92a-13b00ce79e23,40247178,3822,3660,162,9
328,de2f2a02-62b7-4346-b92a-13b00ce79e23,40247178,3975,3840,135,10
328,de2f2a02-62b7-4346-b92a-13b00ce79e23,40247178,4111,3982,129,11
328,de2f2a02-62b7-4346-b92a-13b00ce79e23,40247178,4466,4132,334,12
328,de2f2a02-62b7-4346-b92a-13b00ce79e23,40247178,4552,4474,78,13
328,de2f2a02-62b7-4346-b92a-13b00ce79e23,40247178,4804,4576,228,14
328,de2f2a02-62b7-4346-b92a-13b00ce79e23,40247178,5002,4807,195,15
328,de2f2a02-62b7-4346-b92a-13b00ce79e23,40247178,5644,5030,614,16
328,de2f2a02-62b7-4346-b92a-13b00ce79e23,40247178,6000,5659,341,17
328,de2f2a02-62b7-4346-b92a-13b00ce79e23,40247178,5916,0,-5916,19
8,327fb42c-9ce8-45d1-bdb3-32b8f8458390,40391395,245,20,225,0
8,327fb42c-9ce8-45d1-bdb3-32b8f8458390,40391395,414,246,168,1
8,327fb42c-9ce8-45d1-bdb3-32b8f8458390,40391395,1165,439,726,2
8,327fb42c-9ce8-45d1-bdb3-32b8f8458390,40391395,2651,1179,1472,3
8,327fb42c-9ce8-45d1-bdb3-32b8f8458390,40391395,4373,2713,1660,4
8,327fb42c-9ce8-45d1-bdb3-32b8f8458390,40391395,4888,2270,-2618,5
8,327fb42c-9ce8-45d1-bdb3-32b8f8458390,40391395,2171,150,-2021,6
8,327fb42c-9ce8-45d1-bdb3-32b8f8458390,40391395,147,142,-5,7
8,7052adfb-743a-4b48-90cd-6f94aa6aa2b9,40391395,309,23,286,0
8,7052adfb-743a-4b48-90cd-6f94aa6aa2b9,40391395,791,318,473,1
8,7052adfb-743a-4b48-90cd-6f94aa6aa2b9,40391395,1331,807,524,2
8,7052adfb-743a-4b48-90cd-6f94aa6aa2b9,40391395,2330,1336,994,3
8,7052adfb-743a-4b48-90cd-6f94aa6aa2b9,40391395,3460,2331,1129,4
8,7dd19b11-cb33-4564-b768-d1ce2ad83418,40390642,499,2,497,0
8,79a919ed-c280-4472-90fe-30f3d1971436,40391395,2230,14,2216,0
8,79a919ed-c280-4472-90fe-30f3d1971436,40391395,3117,2238,879,1
8,79a919ed-c280-4472-90fe-30f3d1971436,40391395,3455,2895,-560,2
8,79a919ed-c280-4472-90fe-30f3d1971436,40391395,2856,1759,-1097,3
8,79a919ed-c280-4472-90fe-30f3d1971436,40383981,959,44,915,0
8,79a919ed-c280-4472-90fe-30f3d1971436,40383981,1455,1009,446,1
8,79a919ed-c280-4472-90fe-30f3d1971436,40383981,1578,1456,122,2
8,c6960ed9-ef5d-4e27-92d3-18e6c5215a96,40385651,1392,20,1372,0
8,8f3e65dd-36fa-49c6-a90c-68f2a757b324,40381233,575,3,572,0
8,8f3e65dd-36fa-49c6-a90c-68f2a757b324,40381233,565,42,-523,2
8,8f3e65dd-36fa-49c6-a90c-68f2a757b324,40391395,708,3,705,0
8,8f3e65dd-36fa-49c6-a90c-68f2a757b324,40391395,1026,722,304,1
8,a4eeb057-1868-4df5-aee8-6296766ead05,40390642,1654,11,1643,0
8,a7edf6d2-ba79-45dd-8b3c-6d1cfad1f4b8,40383981,326,28,298,0
8,a7edf6d2-ba79-45dd-8b3c-6d1cfad1f4b8,40383981,1843,390,1453,1
8,a7edf6d2-ba79-45dd-8b3c-6d1cfad1f4b8,40383981,1850,1845,5,2
8,a7edf6d2-ba79-45dd-8b3c-6d1cfad1f4b8,40383981,2007,1861,146,4
8,9a8b2d9a-638a-4d86-bc2c-559ad3650265,40391819,21,21,0,0
8,9a8b2d9a-638a-4d86-bc2c-559ad3650265,40391819,741,102,639,1
8,9a8b2d9a-638a-4d86-bc2c-559ad3650265,40391819,390,0,-390,2
8,f32a40e1-b781-4ed8-acb9-831bedb8f6da,40378913,273,19,254,0
8,f32a40e1-b781-4ed8-acb9-831bedb8f6da,40378913,921,307,614,1
8,291623bb-aa8c-4e73-9ef2-7166e4c21727,40383699,1528,29,1499,0
8,291623bb-aa8c-4e73-9ef2-7166e4c21727,40383699,1605,1538,67,1
8,1cde80b1-5e88-4623-9425-2408c3fcc824,40386827,966,13,953,0
8,1cde80b1-5e88-4623-9425-2408c3fcc824,40386827,1100,43,-1057,1
8,47325e14-0027-4e99-a75f-14586fed575e,40391764,802,19,783,0
8,47325e14-0027-4e99-a75f-14586fed575e,40391764,1169,836,333,1
8,e4827e99-222e-410e-963a-5d54aa7cae44,40378981,2024,28,1996,0
8,e4827e99-222e-410e-963a-5d54aa7cae44,40378981,2019,1712,-307,1
8,e4827e99-222e-410e-963a-5d54aa7cae44,40378981,1758,275,-1483,2
8,e4827e99-222e-410e-963a-5d54aa7cae44,40378981,244,3,-241,3
8,7c15687e-ee5c-4356-8bbf-2138e5312328,40391221,667,8,659,0
8,7c15687e-ee5c-4356-8bbf-2138e5312328,40391221,923,673,250,1
8,7c15687e-ee5c-4356-8bbf-2138e5312328,40391221,3189,931,2258,2
8,7c15687e-ee5c-4356-8bbf-2138e5312328,40391221,2036,1575,-461,3
8,58f8eade-43db-4214-af33-37d5bde9d491,40036526,108,5,103,0
8,58f8eade-43db-4214-af33-37d5bde9d491,40036526,602,129,473,1
8,58f8eade-43db-4214-af33-37d5bde9d491,40036526,835,310,-525,2
8,58f8eade-43db-4214-af33-37d5bde9d491,40036526,308,249,-59,3
8,bcff33bc-adc7-4c35-a50d-172bf3720c78,40382877,817,17,800,0
8,bcff33bc-adc7-4c35-a50d-172bf3720c78,40382877,1649,448,-1201,1
8,bcff33bc-adc7-4c35-a50d-172bf3720c78,40382877,386,5,-381,2
8,dfc8951c-6abe-480b-aebd-a3b53c6baed2,40380403,252,16,236,0
8,dfc8951c-6abe-480b-aebd-a3b53c6baed2,40380403,698,254,444,1
8,dfc8951c-6abe-480b-aebd-a3b53c6baed2,40380403,946,693,-253,2
8,dfc8951c-6abe-480b-aebd-a3b53c6baed2,40380403,680,590,-90,3
8,a4eec59b-ff6b-48c7-9622-e680d8dfb42b,40391764,234,10,224,0
8,8ea30ae1-7881-4b95-aec7-400bc984ecac,40380403,313,11,302,0
8,8ea30ae1-7881-4b95-aec7-400bc984ecac,40380403,1457,316,1141,1
8,8ea30ae1-7881-4b95-aec7-400bc984ecac,40380403,1709,1383,-326,2
8,b4020d5b-bb70-4423-a2c6-cb21454f3d22,40354990,204,3,201,0
8,b4020d5b-bb70-4423-a2c6-cb21454f3d22,40354990,518,221,297,1
8,b4020d5b-bb70-4423-a2c6-cb21454f3d22,40354990,511,6,-505,2
8,694be98e-155a-4a84-8e3d-0771c17c274d,40409981,410,123,287,0
8,694be98e-155a-4a84-8e3d-0771c17c274d,40409981,1241,465,776,1
8,694be98e-155a-4a84-8e3d-0771c17c274d,40409981,887,418,-469,2
8,694be98e-155a-4a84-8e3d-0771c17c274d,40409490,611,13,598,0
8,694be98e-155a-4a84-8e3d-0771c17c274d,40409490,3901,619,3282,1
8,694be98e-155a-4a84-8e3d-0771c17c274d,40409490,3855,2109,-1746,2
8,8d6ad5cf-0613-4d37-a590-e2309f133bba,40405576,147,18,129,0
8,8d6ad5cf-0613-4d37-a590-e2309f133bba,40405576,1277,152,1125,1
8,8d6ad5cf-0613-4d37-a590-e2309f133bba,40405576,1815,1286,529,2
8,8d6ad5cf-0613-4d37-a590-e2309f133bba,40405576,1819,1816,3,3
8,21932d4b-f4e6-4bc2-9a26-cccdf0473c17,40453054,243,23,220,0
8,21932d4b-f4e6-4bc2-9a26-cccdf0473c17,40453054,410,249,161,1
8,21932d4b-f4e6-4bc2-9a26-cccdf0473c17,40453054,526,421,105,2
8,21932d4b-f4e6-4bc2-9a26-cccdf0473c17,40453054,659,558,101,3
8,21932d4b-f4e6-4bc2-9a26-cccdf0473c17,40453054,898,681,217,4
8,21932d4b-f4e6-4bc2-9a26-cccdf0473c17,40453054,1069,903,166,5
8,21932d4b-f4e6-4bc2-9a26-cccdf0473c17,40453054,1319,1094,225,6
8,21932d4b-f4e6-4bc2-9a26-cccdf0473c17,40453054,1539,1327,212,7
8,21932d4b-f4e6-4bc2-9a26-cccdf0473c17,40453054,1746,1540,206,8
8,21932d4b-f4e6-4bc2-9a26-cccdf0473c17,40453054,1936,1762,174,9
8,21932d4b-f4e6-4bc2-9a26-cccdf0473c17,40453054,2187,1944,243,10
8,21932d4b-f4e6-4bc2-9a26-cccdf0473c17,40453054,2437,2210,227,11
8,21932d4b-f4e6-4bc2-9a26-cccdf0473c17,40453054,2522,2438,84,12
8,21932d4b-f4e6-4bc2-9a26-cccdf0473c17,40453054,2611,2526,85,13
8,21932d4b-f4e6-4bc2-9a26-cccdf0473c17,40453054,2857,2613,244,14
8,21932d4b-f4e6-4bc2-9a26-cccdf0473c17,40453054,3160,2860,300,15
8,21932d4b-f4e6-4bc2-9a26-cccdf0473c17,40453054,3501,3169,332,16
8,21932d4b-f4e6-4bc2-9a26-cccdf0473c17,40453054,3512,3505,7,17
8,21932d4b-f4e6-4bc2-9a26-cccdf0473c17,40453054,3802,3670,132,18
8,a868b226-d893-4f04-a782-8e940236e839,40452360,204,46,158,0
8,a868b226-d893-4f04-a782-8e940236e839,40452360,504,216,288,1
8,a868b226-d893-4f04-a782-8e940236e839,40452360,818,523,295,2
8,a868b226-d893-4f04-a782-8e940236e839,40452360,1162,833,329,3
8,a868b226-d893-4f04-a782-8e940236e839,40452360,1453,1165,288,4
8,a868b226-d893-4f04-a782-8e940236e839,40452360,1982,1479,503,5
8,a868b226-d893-4f04-a782-8e940236e839,40452360,2313,1985,328,6
8,a868b226-d893-4f04-a782-8e940236e839,40452360,2694,2337,357,7
8,a868b226-d893-4f04-a782-8e940236e839,40452360,2697,2105,-592,8
8,a868b226-d893-4f04-a782-8e940236e839,40452360,2090,1783,-307,9
357,f6011a98-9911-4e35-8ad4-aa2e6e56daff,40590000,0,0,0,0
357,f6011a98-9911-4e35-8ad4-aa2e6e56daff,40590000,0,0,0,1
357,f6011a98-9911-4e35-8ad4-aa2e6e56daff,40590000,1512,4,1508,2
357,f6011a98-9911-4e35-8ad4-aa2e6e56daff,40590000,1992,1553,439,3
357,f6011a98-9911-4e35-8ad4-aa2e6e56daff,40590000,1935,1482,-453,4
357,f6011a98-9911-4e35-8ad4-aa2e6e56daff,40590000,1439,77,-1362,5
357,f6011a98-9911-4e35-8ad4-aa2e6e56daff,40590000,56,0,-56,6
357,779166b0-c142-4ac6-b0e2-74adc7b3c9c6,40592450,507,15,492,0
357,779166b0-c142-4ac6-b0e2-74adc7b3c9c6,40592450,506,86,-420,2
357,779166b0-c142-4ac6-b0e2-74adc7b3c9c6,40592450,0,0,0,3
364,205d605e-7b4a-4e70-9aba-e136f92a4c87,40592808,157,0,-157,0
364,205d605e-7b4a-4e70-9aba-e136f92a4c87,40592808,3453,1,3452,1
364,205d605e-7b4a-4e70-9aba-e136f92a4c87,40592808,6168,3573,2595,2
364,205d605e-7b4a-4e70-9aba-e136f92a4c87,40597244,469,13,456,0
364,205d605e-7b4a-4e70-9aba-e136f92a4c87,40597244,546,480,66,1
364,205d605e-7b4a-4e70-9aba-e136f92a4c87,40597244,548,548,0,2
364,205d605e-7b4a-4e70-9aba-e136f92a4c87,40597244,1354,569,785,3
364,205d605e-7b4a-4e70-9aba-e136f92a4c87,40597244,1619,1356,263,4
8,5f5be5e8-f39a-413c-91a8-ed7643335735,40589510,119,8,111,0
8,5f5be5e8-f39a-413c-91a8-ed7643335735,40589510,1365,121,1244,1
8,5f5be5e8-f39a-413c-91a8-ed7643335735,40589510,1374,1368,6,2
8,5f5be5e8-f39a-413c-91a8-ed7643335735,40589510,1582,1377,205,3
8,5f5be5e8-f39a-413c-91a8-ed7643335735,40589510,1758,1596,162,4
8,5f5be5e8-f39a-413c-91a8-ed7643335735,40589510,2199,1761,438,5
8,5f5be5e8-f39a-413c-91a8-ed7643335735,40589510,2476,2218,258,6
8,5f5be5e8-f39a-413c-91a8-ed7643335735,40597514,430,12,418,0
8,5f5be5e8-f39a-413c-91a8-ed7643335735,40597514,1326,456,870,1
8,5f5be5e8-f39a-413c-91a8-ed7643335735,40597514,1481,1345,136,2
8,b9dde3b2-9db8-4a70-945a-3e20ca02b8cc,40597244,34,34,0,0
8,b9dde3b2-9db8-4a70-945a-3e20ca02b8cc,40597244,683,74,609,1
8,b9dde3b2-9db8-4a70-945a-3e20ca02b8cc,40597244,1442,700,742,2
8,b9dde3b2-9db8-4a70-945a-3e20ca02b8cc,40597244,1823,1456,367,3
8,b9dde3b2-9db8-4a70-945a-3e20ca02b8cc,40597244,2108,1829,279,4
8,c3808643-5509-4b23-91ac-caf572ed10a5,40598483,1988,4,1984,0
8,c3808643-5509-4b23-91ac-caf572ed10a5,40598483,2117,2001,116,1
8,0d1f8447-916e-43b1-9689-e4f53545f430,40593286,3738,8,3730,0
8,0d1f8447-916e-43b1-9689-e4f53545f430,40593286,3988,3791,197,1
356,8681e5c0-d575-4397-87f4-1a4558829985,40598015,1513,20,1493,0
356,8681e5c0-d575-4397-87f4-1a4558829985,40598015,1826,1539,287,1
356,8681e5c0-d575-4397-87f4-1a4558829985,40598015,1626,1464,-162,2
356,8681e5c0-d575-4397-87f4-1a4558829985,40598015,1462,1331,-131,4
356,8681e5c0-d575-4397-87f4-1a4558829985,40598015,1330,1328,-2,5
356,8681e5c0-d575-4397-87f4-1a4558829985,40598015,1313,1128,-185,7
356,8681e5c0-d575-4397-87f4-1a4558829985,40598015,1125,1122,-3,8
356,8681e5c0-d575-4397-87f4-1a4558829985,40598015,1113,30,-1083,11
356,8681e5c0-d575-4397-87f4-1a4558829985,40598015,0,0,0,12
356,8681e5c0-d575-4397-87f4-1a4558829985,40598015,111,14,97,17
356,8681e5c0-d575-4397-87f4-1a4558829985,40598015,382,113,269,19
356,8681e5c0-d575-4397-87f4-1a4558829985,40598015,547,400,147,24
356,8681e5c0-d575-4397-87f4-1a4558829985,40598015,940,562,378,25
356,8681e5c0-d575-4397-87f4-1a4558829985,40598015,963,944,19,26
356,8681e5c0-d575-4397-87f4-1a4558829985,40598015,1343,967,376,27
356,8681e5c0-d575-4397-87f4-1a4558829985,40598351,304,8,296,0
356,8681e5c0-d575-4397-87f4-1a4558829985,40598351,780,314,466,1
356,8681e5c0-d575-4397-87f4-1a4558829985,40598351,819,787,32,2
356,8681e5c0-d575-4397-87f4-1a4558829985,40598351,933,828,105,3
328,079ae5a6-95ec-4baf-b18e-2edc010658bc,40608002,632,47,585,0
328,079ae5a6-95ec-4baf-b18e-2edc010658bc,40608002,820,637,183,1
328,079ae5a6-95ec-4baf-b18e-2edc010658bc,40608002,962,830,132,2
328,079ae5a6-95ec-4baf-b18e-2edc010658bc,40608002,1507,1009,498,3
328,079ae5a6-95ec-4baf-b18e-2edc010658bc,40608002,1904,1529,375,4
328,079ae5a6-95ec-4baf-b18e-2edc010658bc,40608002,2123,1911,212,5
328,079ae5a6-95ec-4baf-b18e-2edc010658bc,40608002,2303,2136,167,6
328,079ae5a6-95ec-4baf-b18e-2edc010658bc,40608002,2612,2305,307,7
328,079ae5a6-95ec-4baf-b18e-2edc010658bc,40608002,2951,2641,310,8
328,079ae5a6-95ec-4baf-b18e-2edc010658bc,40608002,4380,3001,1379,9
328,079ae5a6-95ec-4baf-b18e-2edc010658bc,40610167,305,11,294,0
328,079ae5a6-95ec-4baf-b18e-2edc010658bc,40610167,662,313,349,1
328,079ae5a6-95ec-4baf-b18e-2edc010658bc,40610167,875,671,204,2
328,079ae5a6-95ec-4baf-b18e-2edc010658bc,40610167,1117,876,241,3
328,079ae5a6-95ec-4baf-b18e-2edc010658bc,40610167,1239,1126,113,5
328,079ae5a6-95ec-4baf-b18e-2edc010658bc,40610167,1350,1256,94,7
328,079ae5a6-95ec-4baf-b18e-2edc010658bc,40610167,1486,1359,127,8
328,079ae5a6-95ec-4baf-b18e-2edc010658bc,40610167,1714,1488,226,9
328,079ae5a6-95ec-4baf-b18e-2edc010658bc,40610167,1892,1727,165,10
328,079ae5a6-95ec-4baf-b18e-2edc010658bc,40610167,1812,0,-1812,19
328,079ae5a6-95ec-4baf-b18e-2edc010658bc,40610167,2497,85,2412,20
328,079ae5a6-95ec-4baf-b18e-2edc010658bc,40610167,4476,0,-4476,21
328,079ae5a6-95ec-4baf-b18e-2edc010658bc,40610167,167,35,132,22
328,079ae5a6-95ec-4baf-b18e-2edc010658bc,40610167,142,20,-122,23
328,079ae5a6-95ec-4baf-b18e-2edc010658bc,40610167,5925,113,5812,24
328,079ae5a6-95ec-4baf-b18e-2edc010658bc,40610167,8192,6015,2177,25
328,079ae5a6-95ec-4baf-b18e-2edc010658bc,40610167,8137,6011,-2126,26
364,39929020-e031-4b4b-b8b6-4a29dd2f3e24,40606244,83,2,81,0
364,39929020-e031-4b4b-b8b6-4a29dd2f3e24,40606244,436,102,334,2
364,39929020-e031-4b4b-b8b6-4a29dd2f3e24,40606244,528,439,89,3
364,39929020-e031-4b4b-b8b6-4a29dd2f3e24,40606244,692,537,155,4
364,39929020-e031-4b4b-b8b6-4a29dd2f3e24,40606244,779,694,85,5
364,39929020-e031-4b4b-b8b6-4a29dd2f3e24,40606244,841,780,61,6
364,39929020-e031-4b4b-b8b6-4a29dd2f3e24,40606244,930,843,87,8
364,39929020-e031-4b4b-b8b6-4a29dd2f3e24,40606244,1021,935,86,9
364,39929020-e031-4b4b-b8b6-4a29dd2f3e24,40606244,1090,1022,68,10
364,39929020-e031-4b4b-b8b6-4a29dd2f3e24,40606244,1137,1091,46,11
364,39929020-e031-4b4b-b8b6-4a29dd2f3e24,40606244,1214,1138,76,12
364,39929020-e031-4b4b-b8b6-4a29dd2f3e24,40606244,1271,1221,50,13
364,39929020-e031-4b4b-b8b6-4a29dd2f3e24,40606244,1332,1273,59,14
364,39929020-e031-4b4b-b8b6-4a29dd2f3e24,40606244,1385,1337,48,15
364,39929020-e031-4b4b-b8b6-4a29dd2f3e24,40606244,1421,1388,33,18
364,39929020-e031-4b4b-b8b6-4a29dd2f3e24,40606244,1491,1427,64,19
364,39929020-e031-4b4b-b8b6-4a29dd2f3e24,40606244,1569,1504,65,21
364,39929020-e031-4b4b-b8b6-4a29dd2f3e24,40606244,1519,470,-1049,27
364,39929020-e031-4b4b-b8b6-4a29dd2f3e24,40606244,421,0,-421,28
364,39929020-e031-4b4b-b8b6-4a29dd2f3e24,40606244,20,0,-20,34
364,39929020-e031-4b4b-b8b6-4a29dd2f3e24,40604732,82,14,68,0
364,39929020-e031-4b4b-b8b6-4a29dd2f3e24,40604732,85,83,2,1
364,39929020-e031-4b4b-b8b6-4a29dd2f3e24,40604732,256,91,165,2
364,39929020-e031-4b4b-b8b6-4a29dd2f3e24,40604732,257,257,0,3
364,39929020-e031-4b4b-b8b6-4a29dd2f3e24,40604732,251,129,-122,4
364,39929020-e031-4b4b-b8b6-4a29dd2f3e24,40604732,2661,145,2516,7
364,39929020-e031-4b4b-b8b6-4a29dd2f3e24,40604732,3876,2717,1159,8
364,39929020-e031-4b4b-b8b6-4a29dd2f3e24,40604732,4020,3917,103,9
364,39929020-e031-4b4b-b8b6-4a29dd2f3e24,40604732,3952,2914,-1038,10
364,39929020-e031-4b4b-b8b6-4a29dd2f3e24,40582046,272,17,255,0
364,39929020-e031-4b4b-b8b6-4a29dd2f3e24,40582046,1240,283,957,1
364,39929020-e031-4b4b-b8b6-4a29dd2f3e24,40582046,1960,1309,651,2
356,afa8f904-bfa9-40bb-8c0a-d26c75d5caa7,40609989,354,7,347,0
356,afa8f904-bfa9-40bb-8c0a-d26c75d5caa7,40609989,393,393,0,1
356,afa8f904-bfa9-40bb-8c0a-d26c75d5caa7,40609989,441,402,39,54
356,57425a68-c99b-4a0d-ac2e-8c67f4e83616,40622173,204,24,180,0
356,57425a68-c99b-4a0d-ac2e-8c67f4e83616,40622623,668,8,660,0
376,533adaa5-a776-4a32-80fc-847c19d11d49,40635443,1062,8,1054,0
376,533adaa5-a776-4a32-80fc-847c19d11d49,40635443,1241,1071,170,1
376,533adaa5-a776-4a32-80fc-847c19d11d49,40635443,1419,1246,173,2
376,533adaa5-a776-4a32-80fc-847c19d11d49,40635443,1476,1421,55,3
376,533adaa5-a776-4a32-80fc-847c19d11d49,40635443,2468,1477,991,4
376,533adaa5-a776-4a32-80fc-847c19d11d49,40635443,2769,2477,292,5
376,533adaa5-a776-4a32-80fc-847c19d11d49,40635443,2765,2738,-27,58
356,d1b377c9-8172-4bc6-9102-0b4ff53ee1e1,40642701,832,21,811,0
356,d1b377c9-8172-4bc6-9102-0b4ff53ee1e1,40642701,3284,913,2371,2
356,d1b377c9-8172-4bc6-9102-0b4ff53ee1e1,40642701,3979,2200,-1779,3
356,d1b377c9-8172-4bc6-9102-0b4ff53ee1e1,40642701,2184,2090,-94,4
356,d1b377c9-8172-4bc6-9102-0b4ff53ee1e1,40642701,3907,2091,1816,10
356,d1b377c9-8172-4bc6-9102-0b4ff53ee1e1,40642701,5064,3977,1087,11
356,d1b377c9-8172-4bc6-9102-0b4ff53ee1e1,40652803,515,13,502,0
356,d1b377c9-8172-4bc6-9102-0b4ff53ee1e1,40652803,1121,540,581,4
356,d1b377c9-8172-4bc6-9102-0b4ff53ee1e1,40652803,1175,1128,47,5
356,d1b377c9-8172-4bc6-9102-0b4ff53ee1e1,40652803,2253,1194,1059,6
356,d1b377c9-8172-4bc6-9102-0b4ff53ee1e1,40652803,0,0,0,11
356,87ccb1cb-2cd2-4538-9b5d-e417c83b6c64,40669333,78,36,42,0
356,87ccb1cb-2cd2-4538-9b5d-e417c83b6c64,40669333,831,122,709,1
356,bdebfad9-d621-4c91-9eab-1b0284e876c5,40673053,529,18,511,0
356,bdebfad9-d621-4c91-9eab-1b0284e876c5,40673053,658,543,115,1
356,bdebfad9-d621-4c91-9eab-1b0284e876c5,40673053,783,664,119,2
356,bdebfad9-d621-4c91-9eab-1b0284e876c5,40673919,173,3,170,0
356,bdebfad9-d621-4c91-9eab-1b0284e876c5,40673919,400,182,218,1
356,bdebfad9-d621-4c91-9eab-1b0284e876c5,40673919,622,402,220,2
356,bdebfad9-d621-4c91-9eab-1b0284e876c5,40673919,753,633,120,5
364,6bfb2dd7-9820-42c7-b82a-537de2172e0e,40667089,156,19,137,0
364,6bfb2dd7-9820-42c7-b82a-537de2172e0e,40667089,363,166,197,1
364,6bfb2dd7-9820-42c7-b82a-537de2172e0e,40667089,438,376,62,2
364,6bfb2dd7-9820-42c7-b82a-537de2172e0e,40667089,585,448,137,3
364,6bfb2dd7-9820-42c7-b82a-537de2172e0e,40667089,669,588,81,4
364,6bfb2dd7-9820-42c7-b82a-537de2172e0e,40667089,720,682,38,5
364,6bfb2dd7-9820-42c7-b82a-537de2172e0e,40667089,772,729,43,6
364,6bfb2dd7-9820-42c7-b82a-537de2172e0e,40667089,806,775,31,7
364,6bfb2dd7-9820-42c7-b82a-537de2172e0e,40667089,867,810,57,8
364,6bfb2dd7-9820-42c7-b82a-537de2172e0e,40667089,874,869,5,9
364,6bfb2dd7-9820-42c7-b82a-537de2172e0e,40667089,1867,895,972,34
364,6bfb2dd7-9820-42c7-b82a-537de2172e0e,40667089,2154,1887,267,35
364,6bfb2dd7-9820-42c7-b82a-537de2172e0e,40667089,2274,2159,115,36
364,6bfb2dd7-9820-42c7-b82a-537de2172e0e,40667089,2321,2277,44,37
364,6bfb2dd7-9820-42c7-b82a-537de2172e0e,40667089,2507,2324,183,38
364,6bfb2dd7-9820-42c7-b82a-537de2172e0e,40667089,2711,2520,191,39
364,6bfb2dd7-9820-42c7-b82a-537de2172e0e,40667089,2794,2717,77,40
364,6bfb2dd7-9820-42c7-b82a-537de2172e0e,40667089,4208,2839,1369,43
364,6bfb2dd7-9820-42c7-b82a-537de2172e0e,40667089,4673,4214,459,44
364,6bfb2dd7-9820-42c7-b82a-537de2172e0e,40667089,5034,4728,306,45
364,6bfb2dd7-9820-42c7-b82a-537de2172e0e,40667089,5033,5031,-2,46
364,6bfb2dd7-9820-42c7-b82a-537de2172e0e,40667089,4790,2841,-1949,47
356,d8eb47e2-856a-4290-8431-37f949b43469,40708853,437,24,413,0
356,d8eb47e2-856a-4290-8431-37f949b43469,40708853,1362,446,916,14
356,d8eb47e2-856a-4290-8431-37f949b43469,40708853,1543,1369,174,15
356,d8eb47e2-856a-4290-8431-37f949b43469,40708853,4062,1612,2450,16
356,d8eb47e2-856a-4290-8431-37f949b43469,40708853,4063,4063,0,17
356,f61a3bda-822d-41d1-ba70-368cca418dc5,40051032,585,13,572,0
356,471723a2-98ba-44d6-a2f4-d68bdb599433,40762246,512,15,497,0
356,471723a2-98ba-44d6-a2f4-d68bdb599433,40762246,517,514,3,1
356,471723a2-98ba-44d6-a2f4-d68bdb599433,40762246,615,523,92,13
356,24439a95-58bc-4e9a-a174-2e5d7f9588a8,40483774,574,1,573,0
356,24439a95-58bc-4e9a-a174-2e5d7f9588a8,40483774,1997,635,1362,3
356,24439a95-58bc-4e9a-a174-2e5d7f9588a8,40483774,3195,2081,1114,4
356,24439a95-58bc-4e9a-a174-2e5d7f9588a8,40483774,3132,947,-2185,5
356,24439a95-58bc-4e9a-a174-2e5d7f9588a8,40483774,926,741,-185,6
356,24439a95-58bc-4e9a-a174-2e5d7f9588a8,40483774,737,689,-48,9
356,24439a95-58bc-4e9a-a174-2e5d7f9588a8,40483774,672,635,-37,10
356,801527de-afe3-464e-acfe-200d3ab1c0a9,40483774,1144,15,1129,0
356,801527de-afe3-464e-acfe-200d3ab1c0a9,40483774,1579,376,-1203,1
356,801527de-afe3-464e-acfe-200d3ab1c0a9,40483774,346,0,-346,2
356,801527de-afe3-464e-acfe-200d3ab1c0a9,40483774,38,0,38,4
356,801527de-afe3-464e-acfe-200d3ab1c0a9,40483774,1404,56,1348,8
356,801527de-afe3-464e-acfe-200d3ab1c0a9,40483774,1912,1454,458,9
356,801527de-afe3-464e-acfe-200d3ab1c0a9,40483774,3195,1928,1267,10
377,a2c531a9-0202-4b18-a4ab-054a17a1983f,41684111,670,73,597,0
377,a2c531a9-0202-4b18-a4ab-054a17a1983f,41684111,680,675,5,1
377,32c05cda-c5f3-417f-902c-5d1761b9089d,41684111,540,32,508,0
377,32c05cda-c5f3-417f-902c-5d1761b9089d,41684111,695,616,79,1
377,32c05cda-c5f3-417f-902c-5d1761b9089d,41683713,525,24,501,0
377,32c05cda-c5f3-417f-902c-5d1761b9089d,41683713,700,553,147,1
378,87f14cfd-bf9e-4a6b-a4b7-e24b63106195,41720244,2208,13,2195,0
378,87f14cfd-bf9e-4a6b-a4b7-e24b63106195,41720244,4002,2259,1743,1
378,87f14cfd-bf9e-4a6b-a4b7-e24b63106195,41720244,2580,0,-2580,2
379,3dec597a-cf2e-45dd-8a5e-49491763b801,41771294,198,14,184,0
379,3dec597a-cf2e-45dd-8a5e-49491763b801,41771294,564,213,351,1
379,3dec597a-cf2e-45dd-8a5e-49491763b801,41771294,1012,577,435,2
379,3dec597a-cf2e-45dd-8a5e-49491763b801,41771294,2003,1014,989,3
379,3dec597a-cf2e-45dd-8a5e-49491763b801,41771294,2899,2063,836,4
379,3dec597a-cf2e-45dd-8a5e-49491763b801,41753022,1937,47,1890,0
379,3dec597a-cf2e-45dd-8a5e-49491763b801,41753022,2179,1969,210,1
379,a9dd39f7-df8c-4a93-b7a6-d37d5058e57e,41772372,449,0,-449,0
379,1a9430f5-498f-4f78-aec6-ca92414024f5,41788898,405,17,388,0
379,1a9430f5-498f-4f78-aec6-ca92414024f5,41788898,470,413,57,1
379,1a9430f5-498f-4f78-aec6-ca92414024f5,41788898,449,0,-449,2
379,6810a543-6863-4d4d-9e85-3a638100b426,41808227,329,20,309,0
379,6810a543-6863-4d4d-9e85-3a638100b426,41808227,542,337,205,1
379,6810a543-6863-4d4d-9e85-3a638100b426,41808227,708,547,161,2
379,6810a543-6863-4d4d-9e85-3a638100b426,41808227,932,713,219,3
379,6810a543-6863-4d4d-9e85-3a638100b426,41808227,1033,934,99,4
379,6810a543-6863-4d4d-9e85-3a638100b426,41808227,1177,1036,141,5
379,6810a543-6863-4d4d-9e85-3a638100b426,41808227,1273,1183,90,10
379,6810a543-6863-4d4d-9e85-3a638100b426,41808227,1316,1280,36,12
379,6810a543-6863-4d4d-9e85-3a638100b426,41808227,1339,1318,21,13
379,6810a543-6863-4d4d-9e85-3a638100b426,41808227,1341,1078,-263,14
379,6810a543-6863-4d4d-9e85-3a638100b426,41808227,1077,1076,-1,15
379,6810a543-6863-4d4d-9e85-3a638100b426,41808227,1379,1108,271,21
379,6810a543-6863-4d4d-9e85-3a638100b426,41808227,1836,1382,454,22
379,6810a543-6863-4d4d-9e85-3a638100b426,41808227,1841,1838,3,23
379,6810a543-6863-4d4d-9e85-3a638100b426,41808227,1963,1856,107,24
379,6810a543-6863-4d4d-9e85-3a638100b426,41808227,2050,1958,92,25
379,6810a543-6863-4d4d-9e85-3a638100b426,41808227,2409,2062,347,26
379,6810a543-6863-4d4d-9e85-3a638100b426,41808227,2411,2411,0,27
379,6810a543-6863-4d4d-9e85-3a638100b426,41808227,2902,2433,469,29
379,6810a543-6863-4d4d-9e85-3a638100b426,41808227,3845,2929,916,30
379,6810a543-6863-4d4d-9e85-3a638100b426,41808227,4124,3854,270,31
379,6810a543-6863-4d4d-9e85-3a638100b426,41808227,4454,4150,304,32
379,ca0ccb3f-a820-44dc-bde0-da8205f4c21d,41802900,96,19,77,0
379,ca0ccb3f-a820-44dc-bde0-da8205f4c21d,41802900,271,107,164,1
379,ca0ccb3f-a820-44dc-bde0-da8205f4c21d,41802900,279,274,5,2
379,ca0ccb3f-a820-44dc-bde0-da8205f4c21d,41802900,307,283,24,3
379,ca0ccb3f-a820-44dc-bde0-da8205f4c21d,41802900,499,313,186,4
379,ca0ccb3f-a820-44dc-bde0-da8205f4c21d,41802900,735,508,227,5
379,ca0ccb3f-a820-44dc-bde0-da8205f4c21d,41802900,873,745,128,6
379,ca0ccb3f-a820-44dc-bde0-da8205f4c21d,41802900,939,876,63,7
379,ca0ccb3f-a820-44dc-bde0-da8205f4c21d,41802900,1099,944,155,8
379,ca0ccb3f-a820-44dc-bde0-da8205f4c21d,41802900,1153,1104,49,9
379,ca0ccb3f-a820-44dc-bde0-da8205f4c21d,41802900,1209,1160,49,10
379,ca0ccb3f-a820-44dc-bde0-da8205f4c21d,41802900,1252,1212,40,11
379,ca0ccb3f-a820-44dc-bde0-da8205f4c21d,41802900,1326,1265,61,12
379,ca0ccb3f-a820-44dc-bde0-da8205f4c21d,41802900,1408,1332,76,15
379,ca0ccb3f-a820-44dc-bde0-da8205f4c21d,41802900,1510,1411,99,16
379,ca0ccb3f-a820-44dc-bde0-da8205f4c21d,41802900,1589,1516,73,17
379,ca0ccb3f-a820-44dc-bde0-da8205f4c21d,41802900,1734,1591,143,18
379,ca0ccb3f-a820-44dc-bde0-da8205f4c21d,41802900,1831,1735,96,19
379,ca0ccb3f-a820-44dc-bde0-da8205f4c21d,41802900,1916,1834,82,20
379,ca0ccb3f-a820-44dc-bde0-da8205f4c21d,41802900,2198,1922,276,21
379,ca0ccb3f-a820-44dc-bde0-da8205f4c21d,41802900,2492,2215,277,22
379,ca0ccb3f-a820-44dc-bde0-da8205f4c21d,41802900,2766,2495,271,23
379,ca0ccb3f-a820-44dc-bde0-da8205f4c21d,41802900,2912,2775,137,24
379,ca0ccb3f-a820-44dc-bde0-da8205f4c21d,41802900,3040,2919,121,25
379,ca0ccb3f-a820-44dc-bde0-da8205f4c21d,41802900,3494,3060,434,26
379,ca0ccb3f-a820-44dc-bde0-da8205f4c21d,41802900,3965,3500,465,27
379,ca0ccb3f-a820-44dc-bde0-da8205f4c21d,41802900,4562,3988,574,28
379,ca0ccb3f-a820-44dc-bde0-da8205f4c21d,41802900,4943,4566,377,29
379,ca0ccb3f-a820-44dc-bde0-da8205f4c21d,41802900,5830,4967,863,30
379,ca0ccb3f-a820-44dc-bde0-da8205f4c21d,41802900,5874,5836,38,31
379,ca0ccb3f-a820-44dc-bde0-da8205f4c21d,41802900,6524,5912,612,32
379,ca0ccb3f-a820-44dc-bde0-da8205f4c21d,41802900,6547,6525,22,33
379,ca0ccb3f-a820-44dc-bde0-da8205f4c21d,41802900,6527,6401,-126,34
379,ca0ccb3f-a820-44dc-bde0-da8205f4c21d,41802900,6481,6405,76,38
379,ca0ccb3f-a820-44dc-bde0-da8205f4c21d,41802900,6547,6488,59,39
379,ca0ccb3f-a820-44dc-bde0-da8205f4c21d,41802900,6516,6224,-292,46
379,ca0ccb3f-a820-44dc-bde0-da8205f4c21d,41807702,94,5,89,0
379,ca0ccb3f-a820-44dc-bde0-da8205f4c21d,41807702,225,95,130,1
379,ca0ccb3f-a820-44dc-bde0-da8205f4c21d,41807702,338,236,102,2
379,ca0ccb3f-a820-44dc-bde0-da8205f4c21d,41807702,488,351,137,3
379,ca0ccb3f-a820-44dc-bde0-da8205f4c21d,41807702,548,496,52,7
379,ca0ccb3f-a820-44dc-bde0-da8205f4c21d,41807702,582,552,30,12
379,ca0ccb3f-a820-44dc-bde0-da8205f4c21d,41807702,624,591,33,14
379,ca0ccb3f-a820-44dc-bde0-da8205f4c21d,41807702,661,625,36,15
379,ca0ccb3f-a820-44dc-bde0-da8205f4c21d,41807702,1098,688,410,17
379,ca0ccb3f-a820-44dc-bde0-da8205f4c21d,41775968,146,0,-146,0
379,ca0ccb3f-a820-44dc-bde0-da8205f4c21d,41775968,423,1,422,1
379,ca0ccb3f-a820-44dc-bde0-da8205f4c21d,41775968,576,438,138,2
379,ca0ccb3f-a820-44dc-bde0-da8205f4c21d,41775968,1317,578,739,3
379,ca0ccb3f-a820-44dc-bde0-da8205f4c21d,41775968,1516,1337,179,4
379,ca0ccb3f-a820-44dc-bde0-da8205f4c21d,41775968,1603,1520,83,5
379,ca0ccb3f-a820-44dc-bde0-da8205f4c21d,41775968,1653,1614,39,6
379,ca0ccb3f-a820-44dc-bde0-da8205f4c21d,41775968,1712,1654,58,7
379,ca0ccb3f-a820-44dc-bde0-da8205f4c21d,41775968,1798,1725,73,8
379,ca0ccb3f-a820-44dc-bde0-da8205f4c21d,41775968,1800,1800,0,9
379,ca0ccb3f-a820-44dc-bde0-da8205f4c21d,41775968,1833,1805,28,10
379,ca0ccb3f-a820-44dc-bde0-da8205f4c21d,41775968,1894,1841,53,11
379,ca0ccb3f-a820-44dc-bde0-da8205f4c21d,41775968,2023,1902,121,12
379,ca0ccb3f-a820-44dc-bde0-da8205f4c21d,41775968,2075,2029,46,13
379,ca0ccb3f-a820-44dc-bde0-da8205f4c21d,41775968,2892,2083,809,14
379,ca0ccb3f-a820-44dc-bde0-da8205f4c21d,41775968,3681,2919,762,15
379,ca0ccb3f-a820-44dc-bde0-da8205f4c21d,41775968,4027,3700,327,16
379,ca0ccb3f-a820-44dc-bde0-da8205f4c21d,41775968,4442,4041,401,17
379,ca0ccb3f-a820-44dc-bde0-da8205f4c21d,41775968,4414,4375,39,21
379,ca0ccb3f-a820-44dc-bde0-da8205f4c21d,41775968,4466,4421,45,22
379,ca0ccb3f-a820-44dc-bde0-da8205f4c21d,41775968,4773,4470,303,23
379,ca0ccb3f-a820-44dc-bde0-da8205f4c21d,41775968,4713,0,-4713,47
380,a0228453-00e6-4ea8-b7f6-abcf15487c37,42721417,833,20,813,0
380,a0228453-00e6-4ea8-b7f6-abcf15487c37,42721417,2385,859,1526,1
380,a0228453-00e6-4ea8-b7f6-abcf15487c37,42721417,2405,0,-2405,2
380,a0228453-00e6-4ea8-b7f6-abcf15487c37,42713108,1128,10,1118,0
380,a0228453-00e6-4ea8-b7f6-abcf15487c37,42713108,3286,1172,2114,1
380,a0228453-00e6-4ea8-b7f6-abcf15487c37,42713108,3409,3300,109,2
380,6313adb4-7db3-48b6-92d3-e5235a610288,42721417,438,5,433,0
380,6313adb4-7db3-48b6-92d3-e5235a610288,42721417,2160,496,1664,1
380,6313adb4-7db3-48b6-92d3-e5235a610288,42721417,3112,769,-2343,2
380,6313adb4-7db3-48b6-92d3-e5235a610288,42721417,594,0,-594,3
380,6313adb4-7db3-48b6-92d3-e5235a610288,42721417,1576,48,1528,5
380,6313adb4-7db3-48b6-92d3-e5235a610288,42721417,662,243,-419,6
380,30d3b109-cf78-46e7-9b95-731a6f252071,42715147,2071,63,2008,0
380,30d3b109-cf78-46e7-9b95-731a6f252071,42715147,2153,0,-2153,1
380,f7d4b81d-7395-4da1-8240-264859063811,42724380,172,22,150,0
380,58a16d39-ec77-45ab-9e25-d4c77da84193,42731505,1223,40,1183,0
380,58a16d39-ec77-45ab-9e25-d4c77da84193,42731505,1549,1273,276,5
380,58a16d39-ec77-45ab-9e25-d4c77da84193,42731505,1531,107,-1424,9
380,58a16d39-ec77-45ab-9e25-d4c77da84193,42731505,49,0,-49,10
380,58a16d39-ec77-45ab-9e25-d4c77da84193,42732842,598,5,593,0
380,58a16d39-ec77-45ab-9e25-d4c77da84193,42732842,1015,602,413,1
380,58a16d39-ec77-45ab-9e25-d4c77da84193,42732842,1620,1018,602,2
380,58a16d39-ec77-45ab-9e25-d4c77da84193,42732842,2296,1621,675,3
380,58a16d39-ec77-45ab-9e25-d4c77da84193,42732842,2976,2325,651,4
380,58a16d39-ec77-45ab-9e25-d4c77da84193,42732842,3523,2983,540,5
381,aa261d12-0fa8-4831-b0f1-1c82c8c334e5,42723401,362,7,355,0
381,aa261d12-0fa8-4831-b0f1-1c82c8c334e5,42732304,350,41,309,0
381,aa261d12-0fa8-4831-b0f1-1c82c8c334e5,42730396,265,22,243,0
381,aa261d12-0fa8-4831-b0f1-1c82c8c334e5,42730396,834,274,560,1
381,aa261d12-0fa8-4831-b0f1-1c82c8c334e5,42730396,1160,842,318,2
381,aa261d12-0fa8-4831-b0f1-1c82c8c334e5,42730396,1162,1162,0,3
381,aa261d12-0fa8-4831-b0f1-1c82c8c334e5,42721115,434,45,389,0
381,aa261d12-0fa8-4831-b0f1-1c82c8c334e5,42721115,1945,446,1499,1
381,aa261d12-0fa8-4831-b0f1-1c82c8c334e5,42721115,2626,1975,651,2
381,aa261d12-0fa8-4831-b0f1-1c82c8c334e5,42721115,3322,2631,691,3
381,aa261d12-0fa8-4831-b0f1-1c82c8c334e5,42721115,4151,3325,826,4
381,6ba8724d-0e19-4066-a339-ba906358013f,42723401,556,21,535,0
381,6ba8724d-0e19-4066-a339-ba906358013f,42723401,995,569,426,1
381,6ba8724d-0e19-4066-a339-ba906358013f,42723401,1668,1039,629,2
381,6ba8724d-0e19-4066-a339-ba906358013f,42723401,1782,1685,97,3
381,6ba8724d-0e19-4066-a339-ba906358013f,42731648,121,7,114,0
381,6ba8724d-0e19-4066-a339-ba906358013f,42731648,532,122,410,1
381,6ba8724d-0e19-4066-a339-ba906358013f,42731648,763,543,220,2
381,6ba8724d-0e19-4066-a339-ba906358013f,42731648,1005,790,215,3
381,6ba8724d-0e19-4066-a339-ba906358013f,42731648,1061,1032,29,4
381,6ba8724d-0e19-4066-a339-ba906358013f,42731648,1048,0,-1048,5
381,6ba8724d-0e19-4066-a339-ba906358013f,42731648,555,6,549,6
381,6ba8724d-0e19-4066-a339-ba906358013f,42731648,1061,610,451,7
381,6ba8724d-0e19-4066-a339-ba906358013f,42731648,1025,117,-908,8
381,6ba8724d-0e19-4066-a339-ba906358013f,42731648,115,112,-3,9
381,56dff423-9b67-4ecd-a0ac-fdfac97bf877,42723401,246,2,244,0
381,56dff423-9b67-4ecd-a0ac-fdfac97bf877,42723401,249,248,1,1
381,56dff423-9b67-4ecd-a0ac-fdfac97bf877,42723401,495,260,235,2
381,56dff423-9b67-4ecd-a0ac-fdfac97bf877,42723401,472,189,-283,4
381,56dff423-9b67-4ecd-a0ac-fdfac97bf877,42723401,176,61,-115,5
381,56dff423-9b67-4ecd-a0ac-fdfac97bf877,42723401,45,0,-45,6
381,56dff423-9b67-4ecd-a0ac-fdfac97bf877,42723401,744,47,697,19
381,56dff423-9b67-4ecd-a0ac-fdfac97bf877,42723401,812,762,50,20
381,56dff423-9b67-4ecd-a0ac-fdfac97bf877,42733993,98,1,97,0
380,b36e87f0-afbf-4e05-9ed0-232d77e6abc9,42741465,386,0,-386,0
380,b36e87f0-afbf-4e05-9ed0-232d77e6abc9,42741465,1252,317,935,1
380,b36e87f0-afbf-4e05-9ed0-232d77e6abc9,42741465,517,0,-517,2
380,b36e87f0-afbf-4e05-9ed0-232d77e6abc9,42741049,1388,20,1368,0
380,b36e87f0-afbf-4e05-9ed0-232d77e6abc9,42741049,1961,1412,549,1
380,b36e87f0-afbf-4e05-9ed0-232d77e6abc9,42741049,1885,989,-896,2
380,b36e87f0-afbf-4e05-9ed0-232d77e6abc9,42741049,945,0,-945,3
381,5115d2f9-bf13-4da2-8985-9ffa6cd6b125,42763760,308,8,300,0
381,5115d2f9-bf13-4da2-8985-9ffa6cd6b125,42763760,3153,360,2793,1
381,5115d2f9-bf13-4da2-8985-9ffa6cd6b125,42763760,3142,1977,-1165,2
381,5115d2f9-bf13-4da2-8985-9ffa6cd6b125,42763760,1888,0,-1888,3
381,5115d2f9-bf13-4da2-8985-9ffa6cd6b125,42764304,486,54,432,0
381,5115d2f9-bf13-4da2-8985-9ffa6cd6b125,42764304,1218,426,792,1
380,649c574d-1560-41f0-ab0e-5ede2a87dec4,42763517,1178,20,1158,0
380,649c574d-1560-41f0-ab0e-5ede2a87dec4,42763517,3310,1187,2123,1
380,649c574d-1560-41f0-ab0e-5ede2a87dec4,42763517,6433,3332,3101,2
380,649c574d-1560-41f0-ab0e-5ede2a87dec4,42763517,7014,6168,-846,3
380,649c574d-1560-41f0-ab0e-5ede2a87dec4,42763517,6155,6059,-96,4
380,649c574d-1560-41f0-ab0e-5ede2a87dec4,42763517,6035,599,-5436,5
380,649c574d-1560-41f0-ab0e-5ede2a87dec4,42763517,518,0,-518,6
380,e4b28ee7-3119-4782-be77-a80832bff04d,42766623,2221,7,2214,0
381,27b2d758-7e04-4320-b2c0-b7a1abe54d07,42766623,3646,29,3617,0
381,27b2d758-7e04-4320-b2c0-b7a1abe54d07,42766623,5175,3731,1444,1
381,27b2d758-7e04-4320-b2c0-b7a1abe54d07,42766623,6303,5188,1115,2
381,18f1c6a6-90fc-441d-8c18-edc643af9a28,42767657,1203,22,1181,0
381,18f1c6a6-90fc-441d-8c18-edc643af9a28,42767657,859,0,-859,1
384,5dfa1975-ed21-4946-a0fb-43fdd779af50,42738079,156,4,152,0
384,5dfa1975-ed21-4946-a0fb-43fdd779af50,42738079,270,158,112,1
384,5dfa1975-ed21-4946-a0fb-43fdd779af50,42738079,322,271,51,2
384,5dfa1975-ed21-4946-a0fb-43fdd779af50,42738079,338,324,14,3
384,5dfa1975-ed21-4946-a0fb-43fdd779af50,42738079,431,339,92,7
384,5dfa1975-ed21-4946-a0fb-43fdd779af50,42738079,436,433,3,8
384,5dfa1975-ed21-4946-a0fb-43fdd779af50,42738079,504,438,66,20
384,5dfa1975-ed21-4946-a0fb-43fdd779af50,42738079,614,506,108,21
384,5dfa1975-ed21-4946-a0fb-43fdd779af50,42738079,744,617,127,22
384,5dfa1975-ed21-4946-a0fb-43fdd779af50,42738079,753,0,-753,23
384,5dfa1975-ed21-4946-a0fb-43fdd779af50,42738079,1174,36,1138,24
384,5dfa1975-ed21-4946-a0fb-43fdd779af50,42738079,1392,1195,197,25
384,5dfa1975-ed21-4946-a0fb-43fdd779af50,42738079,2242,1418,824,26
384,5dfa1975-ed21-4946-a0fb-43fdd779af50,42738079,3637,2258,1379,27
384,5dfa1975-ed21-4946-a0fb-43fdd779af50,42738079,3631,2975,-656,30
384,5dfa1975-ed21-4946-a0fb-43fdd779af50,42738079,2918,2002,-916,31
384,5dfa1975-ed21-4946-a0fb-43fdd779af50,42738079,1974,1716,-258,32
384,5dfa1975-ed21-4946-a0fb-43fdd779af50,42738079,1722,1563,159,33
384,5dfa1975-ed21-4946-a0fb-43fdd779af50,42738079,1738,1723,15,34
384,5dfa1975-ed21-4946-a0fb-43fdd779af50,42738079,1774,1740,34,35
384,5dfa1975-ed21-4946-a0fb-43fdd779af50,42738079,1789,1775,14,36
384,5dfa1975-ed21-4946-a0fb-43fdd779af50,42738079,1802,1791,11,37
384,5dfa1975-ed21-4946-a0fb-43fdd779af50,42738079,1833,1804,29,38
384,5dfa1975-ed21-4946-a0fb-43fdd779af50,42738079,1845,1834,11,39
384,5dfa1975-ed21-4946-a0fb-43fdd779af50,42738079,1903,1846,57,40
384,5dfa1975-ed21-4946-a0fb-43fdd779af50,42738079,1946,1904,42,41
384,5dfa1975-ed21-4946-a0fb-43fdd779af50,42738079,1987,1947,40,42
384,5dfa1975-ed21-4946-a0fb-43fdd779af50,42738079,2020,1988,32,43
384,5dfa1975-ed21-4946-a0fb-43fdd779af50,42738079,2044,2021,23,44
384,5dfa1975-ed21-4946-a0fb-43fdd779af50,42738079,2080,2045,35,45
384,5dfa1975-ed21-4946-a0fb-43fdd779af50,42738079,2133,2081,52,46
384,5dfa1975-ed21-4946-a0fb-43fdd779af50,42738079,2140,2134,6,47
384,5dfa1975-ed21-4946-a0fb-43fdd779af50,42738079,2210,2142,68,48
384,5dfa1975-ed21-4946-a0fb-43fdd779af50,42738079,2289,2212,77,49
384,5dfa1975-ed21-4946-a0fb-43fdd779af50,42738079,2400,2290,110,50
384,5dfa1975-ed21-4946-a0fb-43fdd779af50,42738079,2510,2403,107,52
384,5dfa1975-ed21-4946-a0fb-43fdd779af50,42738079,2585,2511,74,53
384,5dfa1975-ed21-4946-a0fb-43fdd779af50,42738079,2684,2587,97,54
384,5dfa1975-ed21-4946-a0fb-43fdd779af50,42738079,2731,2690,41,55
384,5dfa1975-ed21-4946-a0fb-43fdd779af50,42738079,2783,2734,49,56
384,5dfa1975-ed21-4946-a0fb-43fdd779af50,42738079,2868,2784,84,57
384,5dfa1975-ed21-4946-a0fb-43fdd779af50,42738079,3192,2873,319,58
384,5dfa1975-ed21-4946-a0fb-43fdd779af50,42738079,3269,3195,74,59
384,5dfa1975-ed21-4946-a0fb-43fdd779af50,42738079,3323,3271,52,60
384,5dfa1975-ed21-4946-a0fb-43fdd779af50,42738079,3354,3324,30,61
384,5dfa1975-ed21-4946-a0fb-43fdd779af50,42738079,3380,3355,25,62
384,5dfa1975-ed21-4946-a0fb-43fdd779af50,42738079,3384,3382,2,63
384,5dfa1975-ed21-4946-a0fb-43fdd779af50,42738079,3507,3383,124,68
384,5dfa1975-ed21-4946-a0fb-43fdd779af50,42738079,3637,3508,129,69
385,44abeeef-74e6-4df5-9182-1e55fada70a9,42782785,1121,7,1114,0
385,44abeeef-74e6-4df5-9182-1e55fada70a9,42782785,1244,1141,103,1
385,f5d8795b-3ebf-4a18-80df-6ef4aa29c7d1,42779953,730,57,673,0
385,f5d8795b-3ebf-4a18-80df-6ef4aa29c7d1,42779953,1185,981,204,8
385,f5d8795b-3ebf-4a18-80df-6ef4aa29c7d1,42779953,1897,1213,684,15
385,f5d8795b-3ebf-4a18-80df-6ef4aa29c7d1,42779953,2119,1917,202,21
385,f5d8795b-3ebf-4a18-80df-6ef4aa29c7d1,42779953,2763,2141,622,28
385,f5d8795b-3ebf-4a18-80df-6ef4aa29c7d1,42779953,3171,2799,372,33
385,f5d8795b-3ebf-4a18-80df-6ef4aa29c7d1,42779953,3195,3183,12,34
385,f5d8795b-3ebf-4a18-80df-6ef4aa29c7d1,42779953,3809,3227,582,41
385,f5d8795b-3ebf-4a18-80df-6ef4aa29c7d1,42779953,3947,3825,122,53
385,f5d8795b-3ebf-4a18-80df-6ef4aa29c7d1,42779953,3901,3706,-195,59
385,f5d8795b-3ebf-4a18-80df-6ef4aa29c7d1,42779953,4002,3708,294,60
385,f5d8795b-3ebf-4a18-80df-6ef4aa29c7d1,42779953,3682,3557,-125,61
385,f5d8795b-3ebf-4a18-80df-6ef4aa29c7d1,42779953,3867,3587,280,63
385,f5d8795b-3ebf-4a18-80df-6ef4aa29c7d1,42779953,3875,3869,6,64
385,f5d8795b-3ebf-4a18-80df-6ef4aa29c7d1,42779953,4043,3906,137,74
385,f5d8795b-3ebf-4a18-80df-6ef4aa29c7d1,42779953,4105,4049,56,75
385,f5d8795b-3ebf-4a18-80df-6ef4aa29c7d1,42779953,4220,4124,-96,76
385,f5d8795b-3ebf-4a18-80df-6ef4aa29c7d1,42779953,4362,4192,170,109
386,3ff86310-1ad7-43f2-a5b5-eb8d7959dd08,42783247,211,5,206,0
386,3ff86310-1ad7-43f2-a5b5-eb8d7959dd08,42783247,481,214,267,1
386,3ff86310-1ad7-43f2-a5b5-eb8d7959dd08,42783247,880,490,390,2
386,3ff86310-1ad7-43f2-a5b5-eb8d7959dd08,42783247,1134,881,253,3
386,3ff86310-1ad7-43f2-a5b5-eb8d7959dd08,42783247,1644,1141,503,4
386,3ff86310-1ad7-43f2-a5b5-eb8d7959dd08,42783247,4021,1663,2358,5
386,3ff86310-1ad7-43f2-a5b5-eb8d7959dd08,42783247,7564,4068,3496,6
386,3ff86310-1ad7-43f2-a5b5-eb8d7959dd08,42783247,9910,7642,2268,7
386,3ff86310-1ad7-43f2-a5b5-eb8d7959dd08,42783247,9884,9543,-341,10
386,3ff86310-1ad7-43f2-a5b5-eb8d7959dd08,42786749,226,1,225,0
386,3ff86310-1ad7-43f2-a5b5-eb8d7959dd08,42786749,440,247,193,1
386,3ff86310-1ad7-43f2-a5b5-eb8d7959dd08,42786749,679,447,232,2
386,3ff86310-1ad7-43f2-a5b5-eb8d7959dd08,42786749,720,680,40,3
386,3ff86310-1ad7-43f2-a5b5-eb8d7959dd08,42786749,745,690,-55,4
386,3ff86310-1ad7-43f2-a5b5-eb8d7959dd08,42786749,920,691,229,5
386,3ff86310-1ad7-43f2-a5b5-eb8d7959dd08,42786749,998,926,72,6
386,3ff86310-1ad7-43f2-a5b5-eb8d7959dd08,42786749,1055,1000,55,7
386,3ff86310-1ad7-43f2-a5b5-eb8d7959dd08,42786749,1045,967,-78,8
386,3ff86310-1ad7-43f2-a5b5-eb8d7959dd08,42786749,965,885,-80,9
386,3ff86310-1ad7-43f2-a5b5-eb8d7959dd08,42786749,1063,900,163,10
386,3ff86310-1ad7-43f2-a5b5-eb8d7959dd08,42786749,1150,1064,86,11
386,3ff86310-1ad7-43f2-a5b5-eb8d7959dd08,42786749,1267,1152,115,12
386,3ff86310-1ad7-43f2-a5b5-eb8d7959dd08,42786749,1337,1275,62,13
386,3ff86310-1ad7-43f2-a5b5-eb8d7959dd08,42786749,1373,1312,-61,14
386,3ff86310-1ad7-43f2-a5b5-eb8d7959dd08,42786749,1398,1314,84,15
386,3ff86310-1ad7-43f2-a5b5-eb8d7959dd08,42786749,1412,1289,-123,16
386,3ff86310-1ad7-43f2-a5b5-eb8d7959dd08,42786749,1324,1271,53,17
386,3ff86310-1ad7-43f2-a5b5-eb8d7959dd08,42786749,1399,1288,-111,18
386,3ff86310-1ad7-43f2-a5b5-eb8d7959dd08,42786749,1284,1173,-111,19
386,3ff86310-1ad7-43f2-a5b5-eb8d7959dd08,42786749,1436,1209,227,20
386,3ff86310-1ad7-43f2-a5b5-eb8d7959dd08,42786749,1639,1438,201,21
386,3ff86310-1ad7-43f2-a5b5-eb8d7959dd08,42786749,1973,1649,324,23
386,3ff86310-1ad7-43f2-a5b5-eb8d7959dd08,42786749,2483,1986,497,24
386,3ff86310-1ad7-43f2-a5b5-eb8d7959dd08,42786749,2570,2486,84,25
386,3ff86310-1ad7-43f2-a5b5-eb8d7959dd08,42786749,2740,2572,168,26
386,3ff86310-1ad7-43f2-a5b5-eb8d7959dd08,42786749,2770,2634,-136,27
386,3ff86310-1ad7-43f2-a5b5-eb8d7959dd08,42786749,3147,2649,498,28
386,3ff86310-1ad7-43f2-a5b5-eb8d7959dd08,42786749,3205,3040,-165,29
386,3ff86310-1ad7-43f2-a5b5-eb8d7959dd08,42786749,3029,2866,-163,30
386,3ff86310-1ad7-43f2-a5b5-eb8d7959dd08,42786749,2958,2868,90,31
386,3ff86310-1ad7-43f2-a5b5-eb8d7959dd08,42786749,3022,2958,64,32
386,3ff86310-1ad7-43f2-a5b5-eb8d7959dd08,42786749,3162,3025,137,33
386,3ff86310-1ad7-43f2-a5b5-eb8d7959dd08,42786749,3409,3166,243,34
386,3ff86310-1ad7-43f2-a5b5-eb8d7959dd08,42786749,3737,3412,325,35
386,3ff86310-1ad7-43f2-a5b5-eb8d7959dd08,42786749,4025,3760,265,36
386,3ff86310-1ad7-43f2-a5b5-eb8d7959dd08,42786749,4546,4033,513,37
386,3ff86310-1ad7-43f2-a5b5-eb8d7959dd08,42786749,4986,4565,421,38
386,3ff86310-1ad7-43f2-a5b5-eb8d7959dd08,42786749,5128,4997,131,39
386,3ff86310-1ad7-43f2-a5b5-eb8d7959dd08,42786749,5311,5132,179,40
386,3ff86310-1ad7-43f2-a5b5-eb8d7959dd08,42786749,5388,5315,73,41
386,3ff86310-1ad7-43f2-a5b5-eb8d7959dd08,42786749,5847,5390,457,42
386,3ff86310-1ad7-43f2-a5b5-eb8d7959dd08,42786749,6094,5851,243,43
386,3ff86310-1ad7-43f2-a5b5-eb8d7959dd08,42786749,6643,6110,533,44
386,3ff86310-1ad7-43f2-a5b5-eb8d7959dd08,42786749,7246,6644,602,45
386,3ff86310-1ad7-43f2-a5b5-eb8d7959dd08,42786749,7288,7248,40,46
386,3ff86310-1ad7-43f2-a5b5-eb8d7959dd08,42786749,7275,7139,-136,49
386,3ff86310-1ad7-43f2-a5b5-eb8d7959dd08,42786749,0,0,0,56
386,3ff86310-1ad7-43f2-a5b5-eb8d7959dd08,42786749,124,6,118,60
386,3ff86310-1ad7-43f2-a5b5-eb8d7959dd08,42786749,144,31,-113,61
386,3ff86310-1ad7-43f2-a5b5-eb8d7959dd08,42786749,161,132,29,62
386,3ff86310-1ad7-43f2-a5b5-eb8d7959dd08,42786749,128,0,-128,64
386,3ff86310-1ad7-43f2-a5b5-eb8d7959dd08,42786749,103,6,97,65
386,3ff86310-1ad7-43f2-a5b5-eb8d7959dd08,42786749,101,0,-101,66
386,3ff86310-1ad7-43f2-a5b5-eb8d7959dd08,42786749,21,3,18,67
386,3ff86310-1ad7-43f2-a5b5-eb8d7959dd08,42786749,124,24,100,68
386,3ff86310-1ad7-43f2-a5b5-eb8d7959dd08,42786749,137,0,-137,69
386,3ff86310-1ad7-43f2-a5b5-eb8d7959dd08,42786749,237,93,144,70
386,3ff86310-1ad7-43f2-a5b5-eb8d7959dd08,42786749,933,254,679,71
386,3ff86310-1ad7-43f2-a5b5-eb8d7959dd08,42786749,1298,960,338,72
386,3ff86310-1ad7-43f2-a5b5-eb8d7959dd08,42786749,1244,0,-1244,73
386,3ff86310-1ad7-43f2-a5b5-eb8d7959dd08,42788510,142,2,140,0
386,3ff86310-1ad7-43f2-a5b5-eb8d7959dd08,42788510,376,145,231,1
386,3ff86310-1ad7-43f2-a5b5-eb8d7959dd08,42788510,534,379,155,2
386,3ff86310-1ad7-43f2-a5b5-eb8d7959dd08,42788510,682,539,143,3
386,3ff86310-1ad7-43f2-a5b5-eb8d7959dd08,42788510,784,687,97,4
386,3ff86310-1ad7-43f2-a5b5-eb8d7959dd08,42788510,818,788,30,5
386,3ff86310-1ad7-43f2-a5b5-eb8d7959dd08,42788510,874,820,54,6
386,3ff86310-1ad7-43f2-a5b5-eb8d7959dd08,42788510,958,878,80,7
386,3ff86310-1ad7-43f2-a5b5-eb8d7959dd08,42788510,908,667,-241,8
386,3ff86310-1ad7-43f2-a5b5-eb8d7959dd08,42788510,910,668,242,9
386,3ff86310-1ad7-43f2-a5b5-eb8d7959dd08,42788510,949,911,38,10
386,3ff86310-1ad7-43f2-a5b5-eb8d7959dd08,42788510,1091,951,140,11
386,3ff86310-1ad7-43f2-a5b5-eb8d7959dd08,42788510,1117,1100,17,12
386,3ff86310-1ad7-43f2-a5b5-eb8d7959dd08,42788510,1214,1122,92,13
386,3ff86310-1ad7-43f2-a5b5-eb8d7959dd08,42788510,1338,1217,121,15
386,3ff86310-1ad7-43f2-a5b5-eb8d7959dd08,42788510,1294,1201,-93,16
386,3ff86310-1ad7-43f2-a5b5-eb8d7959dd08,42788510,1251,1214,37,17
386,3ff86310-1ad7-43f2-a5b5-eb8d7959dd08,42788510,1304,1253,51,18
386,3ff86310-1ad7-43f2-a5b5-eb8d7959dd08,42788510,1447,1306,141,19
386,3ff86310-1ad7-43f2-a5b5-eb8d7959dd08,42788510,1566,1454,112,20
386,3ff86310-1ad7-43f2-a5b5-eb8d7959dd08,42788510,1579,1568,11,21
386,3ff86310-1ad7-43f2-a5b5-eb8d7959dd08,42788510,1649,1584,65,22
386,3ff86310-1ad7-43f2-a5b5-eb8d7959dd08,42788510,1685,1651,34,23
386,3ff86310-1ad7-43f2-a5b5-eb8d7959dd08,42788510,1704,1686,18,24
386,3ff86310-1ad7-43f2-a5b5-eb8d7959dd08,42788510,1717,1706,11,25
386,3ff86310-1ad7-43f2-a5b5-eb8d7959dd08,42788510,1820,1719,101,26
386,3ff86310-1ad7-43f2-a5b5-eb8d7959dd08,42788510,2152,1823,329,58
386,3ff86310-1ad7-43f2-a5b5-eb8d7959dd08,42788510,2687,2153,534,59
386,3ff86310-1ad7-43f2-a5b5-eb8d7959dd08,42788510,3769,2692,1077,60
386,3ff86310-1ad7-43f2-a5b5-eb8d7959dd08,42788510,4020,3792,228,61
386,3ff86310-1ad7-43f2-a5b5-eb8d7959dd08,42788510,4172,3953,-219,62
386,3ff86310-1ad7-43f2-a5b5-eb8d7959dd08,42788510,4048,3956,92,64
386,3ff86310-1ad7-43f2-a5b5-eb8d7959dd08,42788510,4047,3924,-123,65
386,3ff86310-1ad7-43f2-a5b5-eb8d7959dd08,42788510,4195,3958,237,66
386,3ff86310-1ad7-43f2-a5b5-eb8d7959dd08,42788510,4746,4212,534,67
386,3ff86310-1ad7-43f2-a5b5-eb8d7959dd08,42788510,4739,4616,-123,68
386,3ff86310-1ad7-43f2-a5b5-eb8d7959dd08,42788510,4608,4169,-439,69
386,3ff86310-1ad7-43f2-a5b5-eb8d7959dd08,42788510,4165,3026,-1139,70
386,3ff86310-1ad7-43f2-a5b5-eb8d7959dd08,42788510,2970,925,-2045,71
386,3ff86310-1ad7-43f2-a5b5-eb8d7959dd08,42788510,901,0,-901,72
386,3ff86310-1ad7-43f2-a5b5-eb8d7959dd08,42788510,726,5,721,73
386,3ff86310-1ad7-43f2-a5b5-eb8d7959dd08,42788510,996,737,259,74
386,3ff86310-1ad7-43f2-a5b5-eb8d7959dd08,42788510,1470,1004,466,75
386,3ff86310-1ad7-43f2-a5b5-eb8d7959dd08,42788510,1490,872,-618,76
386,3ff86310-1ad7-43f2-a5b5-eb8d7959dd08,42788510,864,0,-864,77
386,3ff86310-1ad7-43f2-a5b5-eb8d7959dd08,42788510,428,19,409,88
386,3ff86310-1ad7-43f2-a5b5-eb8d7959dd08,42788510,404,2,-402,89
386,3ff86310-1ad7-43f2-a5b5-eb8d7959dd08,42788510,979,42,937,95
386,3ff86310-1ad7-43f2-a5b5-eb8d7959dd08,42788510,2683,1024,1659,96
386,3ff86310-1ad7-43f2-a5b5-eb8d7959dd08,42788510,2908,1160,-1748,97
386,3ff86310-1ad7-43f2-a5b5-eb8d7959dd08,42788510,1124,497,-627,98
386,3ff86310-1ad7-43f2-a5b5-eb8d7959dd08,42788510,476,0,-476,99
386,3ff86310-1ad7-43f2-a5b5-eb8d7959dd08,42788510,511,2,509,111
386,3ff86310-1ad7-43f2-a5b5-eb8d7959dd08,42788510,2700,539,2161,112
386,3ff86310-1ad7-43f2-a5b5-eb8d7959dd08,42788510,4301,2744,1557,113
386,3ff86310-1ad7-43f2-a5b5-eb8d7959dd08,42788510,4746,4319,427,114
386,3ff86310-1ad7-43f2-a5b5-eb8d7959dd08,42788510,4729,4560,-169,116
386,3ff86310-1ad7-43f2-a5b5-eb8d7959dd08,42788510,4746,4563,183,117
386,3ff86310-1ad7-43f2-a5b5-eb8d7959dd08,42788510,4742,4149,-593,118
386,3ff86310-1ad7-43f2-a5b5-eb8d7959dd08,42788510,4143,1118,-3025,119
386,3ff86310-1ad7-43f2-a5b5-eb8d7959dd08,42788510,1092,0,-1092,120
386,753f2380-99ac-4cc7-a751-9a6f86a18242,42787529,499,21,478,0
386,753f2380-99ac-4cc7-a751-9a6f86a18242,42787529,1595,571,1024,1
386,753f2380-99ac-4cc7-a751-9a6f86a18242,42787529,1015,554,-461,2
386,753f2380-99ac-4cc7-a751-9a6f86a18242,42787529,667,549,118,3
386,753f2380-99ac-4cc7-a751-9a6f86a18242,42787529,665,523,-142,4
386,753f2380-99ac-4cc7-a751-9a6f86a18242,42787529,522,74,-448,5
386,753f2380-99ac-4cc7-a751-9a6f86a18242,42787529,66,0,-66,6
386,753f2380-99ac-4cc7-a751-9a6f86a18242,42787529,407,3,404,7
386,753f2380-99ac-4cc7-a751-9a6f86a18242,42787529,802,418,384,8
386,753f2380-99ac-4cc7-a751-9a6f86a18242,42787529,1073,828,245,9
386,753f2380-99ac-4cc7-a751-9a6f86a18242,42787529,1152,1074,78,10
386,753f2380-99ac-4cc7-a751-9a6f86a18242,42787529,1157,1036,121,11
386,753f2380-99ac-4cc7-a751-9a6f86a18242,42787529,1400,1166,234,12
386,753f2380-99ac-4cc7-a751-9a6f86a18242,42787529,1589,1402,187,13
386,753f2380-99ac-4cc7-a751-9a6f86a18242,42787529,1648,1510,138,14
386,753f2380-99ac-4cc7-a751-9a6f86a18242,42787529,1680,1636,44,15
386,753f2380-99ac-4cc7-a751-9a6f86a18242,42787529,1854,1693,161,16
386,753f2380-99ac-4cc7-a751-9a6f86a18242,42787529,2452,1859,593,17
386,753f2380-99ac-4cc7-a751-9a6f86a18242,42787529,3074,2498,576,18
386,753f2380-99ac-4cc7-a751-9a6f86a18242,42787529,3434,3122,312,19
386,753f2380-99ac-4cc7-a751-9a6f86a18242,42787529,3432,2818,-614,20
386,753f2380-99ac-4cc7-a751-9a6f86a18242,42787529,2784,2083,-701,21
386,753f2380-99ac-4cc7-a751-9a6f86a18242,42787529,2059,1379,-680,22
386,753f2380-99ac-4cc7-a751-9a6f86a18242,42787529,1372,611,-761,23
386,753f2380-99ac-4cc7-a751-9a6f86a18242,42787529,600,0,-600,24
386,753f2380-99ac-4cc7-a751-9a6f86a18242,42787529,498,5,493,26
386,753f2380-99ac-4cc7-a751-9a6f86a18242,42787529,946,507,439,27
386,753f2380-99ac-4cc7-a751-9a6f86a18242,42787529,1157,950,207,28
386,753f2380-99ac-4cc7-a751-9a6f86a18242,42787529,1332,1179,153,29
386,753f2380-99ac-4cc7-a751-9a6f86a18242,42787529,1425,1339,86,30
386,753f2380-99ac-4cc7-a751-9a6f86a18242,42787529,1424,1200,-224,31
386,753f2380-99ac-4cc7-a751-9a6f86a18242,42787529,1254,1203,51,32
386,753f2380-99ac-4cc7-a751-9a6f86a18242,42787529,1341,1256,85,33
386,753f2380-99ac-4cc7-a751-9a6f86a18242,42787529,1784,1344,440,34
386,753f2380-99ac-4cc7-a751-9a6f86a18242,42787529,2022,1795,227,35
386,753f2380-99ac-4cc7-a751-9a6f86a18242,42787529,2198,2034,164,36
386,753f2380-99ac-4cc7-a751-9a6f86a18242,42787529,2388,2201,187,40
386,753f2380-99ac-4cc7-a751-9a6f86a18242,42787529,2447,2391,56,41
386,753f2380-99ac-4cc7-a751-9a6f86a18242,42787529,2559,2453,106,42
386,753f2380-99ac-4cc7-a751-9a6f86a18242,42787529,2586,2561,25,43
386,753f2380-99ac-4cc7-a751-9a6f86a18242,42787529,2602,2587,15,44
386,753f2380-99ac-4cc7-a751-9a6f86a18242,42787529,2671,2603,68,46
386,753f2380-99ac-4cc7-a751-9a6f86a18242,42787529,2748,2672,76,47
386,753f2380-99ac-4cc7-a751-9a6f86a18242,42787529,2765,2413,-352,48
386,753f2380-99ac-4cc7-a751-9a6f86a18242,42787529,2394,2120,-274,49
386,753f2380-99ac-4cc7-a751-9a6f86a18242,42787529,2124,2124,0,50
386,753f2380-99ac-4cc7-a751-9a6f86a18242,42787529,2238,2132,106,51
386,753f2380-99ac-4cc7-a751-9a6f86a18242,42787529,2256,2247,9,52
386,753f2380-99ac-4cc7-a751-9a6f86a18242,42787529,2369,2265,104,53
386,753f2380-99ac-4cc7-a751-9a6f86a18242,42787529,2746,2371,375,56
386,753f2380-99ac-4cc7-a751-9a6f86a18242,42787529,2941,2748,193,57
386,753f2380-99ac-4cc7-a751-9a6f86a18242,42787529,2711,2140,-571,58
386,753f2380-99ac-4cc7-a751-9a6f86a18242,42787529,2132,2110,-22,59
386,753f2380-99ac-4cc7-a751-9a6f86a18242,42787529,2109,2109,0,60
386,753f2380-99ac-4cc7-a751-9a6f86a18242,42787529,2068,1761,-307,77
386,753f2380-99ac-4cc7-a751-9a6f86a18242,42787529,1762,1577,-185,78
386,753f2380-99ac-4cc7-a751-9a6f86a18242,42787529,1570,1364,-206,79
386,753f2380-99ac-4cc7-a751-9a6f86a18242,42787529,1360,1297,-63,80
386,753f2380-99ac-4cc7-a751-9a6f86a18242,42787529,1288,1194,-94,82
386,753f2380-99ac-4cc7-a751-9a6f86a18242,42787529,1193,1003,-190,83
386,753f2380-99ac-4cc7-a751-9a6f86a18242,42787529,998,877,-121,84
386,753f2380-99ac-4cc7-a751-9a6f86a18242,42787529,873,765,-108,85
386,753f2380-99ac-4cc7-a751-9a6f86a18242,42787529,761,633,-128,86
386,753f2380-99ac-4cc7-a751-9a6f86a18242,42787529,627,489,-138,87
386,753f2380-99ac-4cc7-a751-9a6f86a18242,42787529,485,290,-195,88
386,753f2380-99ac-4cc7-a751-9a6f86a18242,42787529,686,296,390,89
386,753f2380-99ac-4cc7-a751-9a6f86a18242,42787529,945,691,254,90
386,753f2380-99ac-4cc7-a751-9a6f86a18242,42787529,1182,952,230,91
386,753f2380-99ac-4cc7-a751-9a6f86a18242,42787529,1350,1185,165,92
386,753f2380-99ac-4cc7-a751-9a6f86a18242,42787529,1527,1364,163,93
386,753f2380-99ac-4cc7-a751-9a6f86a18242,42787529,1607,1528,79,94
386,753f2380-99ac-4cc7-a751-9a6f86a18242,42787529,1635,1609,26,95
386,753f2380-99ac-4cc7-a751-9a6f86a18242,42787529,1787,1643,144,96
386,753f2380-99ac-4cc7-a751-9a6f86a18242,42787529,1839,1789,50,97
386,753f2380-99ac-4cc7-a751-9a6f86a18242,42787529,2514,1840,674,98
386,753f2380-99ac-4cc7-a751-9a6f86a18242,42787529,3283,2517,766,99
386,753f2380-99ac-4cc7-a751-9a6f86a18242,42787529,3299,3164,-135,100
386,753f2380-99ac-4cc7-a751-9a6f86a18242,42787529,3247,3158,89,101
386,753f2380-99ac-4cc7-a751-9a6f86a18242,42787529,3310,3248,62,102
386,753f2380-99ac-4cc7-a751-9a6f86a18242,42787529,3308,3236,-72,103
386,753f2380-99ac-4cc7-a751-9a6f86a18242,42787529,3434,3245,189,110
386,753f2380-99ac-4cc7-a751-9a6f86a18242,42787529,3402,2878,-524,111
386,753f2380-99ac-4cc7-a751-9a6f86a18242,42787529,2817,0,-2817,112
386,753f2380-99ac-4cc7-a751-9a6f86a18242,42787419,497,5,492,0
386,753f2380-99ac-4cc7-a751-9a6f86a18242,42787419,502,498,4,1
386,753f2380-99ac-4cc7-a751-9a6f86a18242,42787419,1007,527,480,6
386,753f2380-99ac-4cc7-a751-9a6f86a18242,42787419,977,848,-129,7
386,753f2380-99ac-4cc7-a751-9a6f86a18242,42787419,847,836,-11,8
386,753f2380-99ac-4cc7-a751-9a6f86a18242,42787419,1187,842,345,11
386,753f2380-99ac-4cc7-a751-9a6f86a18242,42787419,1226,1188,38,12
386,753f2380-99ac-4cc7-a751-9a6f86a18242,42787419,1312,1237,75,13
386,753f2380-99ac-4cc7-a751-9a6f86a18242,42787419,1272,1251,21,14
386,753f2380-99ac-4cc7-a751-9a6f86a18242,42787419,1275,1265,-10,15
386,753f2380-99ac-4cc7-a751-9a6f86a18242,42787419,1264,1264,0,16
386,753f2380-99ac-4cc7-a751-9a6f86a18242,42787419,1302,1267,35,18
386,753f2380-99ac-4cc7-a751-9a6f86a18242,42787419,1408,1305,103,19
386,753f2380-99ac-4cc7-a751-9a6f86a18242,42787419,1453,1409,44,20
386,753f2380-99ac-4cc7-a751-9a6f86a18242,42787419,1503,1455,48,21
386,753f2380-99ac-4cc7-a751-9a6f86a18242,42787419,1663,1512,151,22
386,753f2380-99ac-4cc7-a751-9a6f86a18242,42787419,1716,1667,49,23
386,753f2380-99ac-4cc7-a751-9a6f86a18242,42787419,1779,1718,61,24
386,753f2380-99ac-4cc7-a751-9a6f86a18242,42787419,1747,1711,-36,25
386,753f2380-99ac-4cc7-a751-9a6f86a18242,42787419,1904,1745,159,26
386,753f2380-99ac-4cc7-a751-9a6f86a18242,42787419,1911,1906,5,27
386,753f2380-99ac-4cc7-a751-9a6f86a18242,42787419,2043,1912,131,28
386,753f2380-99ac-4cc7-a751-9a6f86a18242,42787419,2173,2047,126,29
386,753f2380-99ac-4cc7-a751-9a6f86a18242,42787419,2125,2107,-18,30
386,753f2380-99ac-4cc7-a751-9a6f86a18242,42787419,2285,2111,174,38
386,753f2380-99ac-4cc7-a751-9a6f86a18242,42787419,2418,2290,128,39
384,9eb7c36e-6b18-475e-b9c9-43055cb03e19,42790624,1044,20,1024,0
384,9eb7c36e-6b18-475e-b9c9-43055cb03e19,42790624,1665,1045,620,1
384,9eb7c36e-6b18-475e-b9c9-43055cb03e19,42790624,2692,1735,957,2
384,9eb7c36e-6b18-475e-b9c9-43055cb03e19,42790624,4128,2737,1391,3
384,9eb7c36e-6b18-475e-b9c9-43055cb03e19,42790624,4691,4153,538,4
384,9eb7c36e-6b18-475e-b9c9-43055cb03e19,42790624,6465,4737,1728,17
384,9eb7c36e-6b18-475e-b9c9-43055cb03e19,42790624,8481,6514,1967,18
384,9eb7c36e-6b18-475e-b9c9-43055cb03e19,42790624,8387,6540,-1847,20
384,9eb7c36e-6b18-475e-b9c9-43055cb03e19,42790624,6497,5897,-600,21
384,9eb7c36e-6b18-475e-b9c9-43055cb03e19,42790624,5888,4598,-1290,22
384,9eb7c36e-6b18-475e-b9c9-43055cb03e19,42790624,4495,572,-3923,23
384,9eb7c36e-6b18-475e-b9c9-43055cb03e19,42790624,861,0,861,24
384,9eb7c36e-6b18-475e-b9c9-43055cb03e19,42790624,1077,883,194,25
384,9eb7c36e-6b18-475e-b9c9-43055cb03e19,42790624,1418,1087,331,39
384,9eb7c36e-6b18-475e-b9c9-43055cb03e19,42790624,2037,1442,595,40
384,9eb7c36e-6b18-475e-b9c9-43055cb03e19,42790624,3106,2044,1062,41
384,9eb7c36e-6b18-475e-b9c9-43055cb03e19,42790624,3108,2545,-563,42
384,9eb7c36e-6b18-475e-b9c9-43055cb03e19,42790624,3012,2524,488,43
385,2c9c06d9-eddf-46a9-bc19-bf55b4f241aa,42800271,844,22,822,0
385,2c9c06d9-eddf-46a9-bc19-bf55b4f241aa,42800271,868,849,19,1
385,2c9c06d9-eddf-46a9-bc19-bf55b4f241aa,42800271,1308,903,405,7
385,2c9c06d9-eddf-46a9-bc19-bf55b4f241aa,42800271,1552,1337,215,8
385,2c9c06d9-eddf-46a9-bc19-bf55b4f241aa,42800271,2004,1568,436,11
385,2c9c06d9-eddf-46a9-bc19-bf55b4f241aa,42799284,675,25,650,0
385,2c9c06d9-eddf-46a9-bc19-bf55b4f241aa,42799284,1233,702,531,10
385,2c9c06d9-eddf-46a9-bc19-bf55b4f241aa,42799284,2140,1248,892,18
385,2c9c06d9-eddf-46a9-bc19-bf55b4f241aa,42799284,2591,2174,417,24
385,2c9c06d9-eddf-46a9-bc19-bf55b4f241aa,42799284,2955,2612,343,30
385,2c9c06d9-eddf-46a9-bc19-bf55b4f241aa,42799284,3028,2973,55,31
385,2c9c06d9-eddf-46a9-bc19-bf55b4f241aa,42799284,3947,3111,836,33
385,2c9c06d9-eddf-46a9-bc19-bf55b4f241aa,42799284,3934,3921,-13,34
385,2c9c06d9-eddf-46a9-bc19-bf55b4f241aa,42787529,229,1,228,0
385,2c9c06d9-eddf-46a9-bc19-bf55b4f241aa,42787529,601,258,343,3
385,2c9c06d9-eddf-46a9-bc19-bf55b4f241aa,42787529,1167,671,496,4
387,cc984e33-479e-4477-9671-0b590114475d,42803812,1003,2,1001,0
387,cc984e33-479e-4477-9671-0b590114475d,42803812,2560,1029,1531,1
387,cc984e33-479e-4477-9671-0b590114475d,42803812,4680,2587,2093,2
387,cc984e33-479e-4477-9671-0b590114475d,42803812,4951,4704,247,3
387,cc984e33-479e-4477-9671-0b590114475d,42803812,4969,4969,0,9509
387,cc984e33-479e-4477-9671-0b590114475d,42803812,5109,4977,132,9510
387,cc984e33-479e-4477-9671-0b590114475d,42803812,7062,5142,1920,9511
387,cc984e33-479e-4477-9671-0b590114475d,42803812,7890,7120,770,9512
391,d1b124e0-ae0d-452b-aa8a-17f409f5c686,42805482,1310,11,1299,0
391,d1b124e0-ae0d-452b-aa8a-17f409f5c686,42805482,4461,1314,3147,1
391,d1b124e0-ae0d-452b-aa8a-17f409f5c686,42805482,4268,0,-4268,2
390,7de36bfb-7329-410a-a618-ec862a03accd,42810724,257,2,255,0
390,7de36bfb-7329-410a-a618-ec862a03accd,42810724,266,260,6,1
390,7de36bfb-7329-410a-a618-ec862a03accd,42810724,1627,278,1349,2
390,7de36bfb-7329-410a-a618-ec862a03accd,42810724,3246,1630,1616,3
390,7de36bfb-7329-410a-a618-ec862a03accd,42810724,3929,3248,681,4
390,7de36bfb-7329-410a-a618-ec862a03accd,42810724,7223,4052,3171,5
390,7de36bfb-7329-410a-a618-ec862a03accd,42810724,8478,7257,1221,6
390,7de36bfb-7329-410a-a618-ec862a03accd,42810724,12423,8485,3938,7
390,7de36bfb-7329-410a-a618-ec862a03accd,42810724,19942,12484,7458,8
390,7de36bfb-7329-410a-a618-ec862a03accd,42810724,23616,20080,3536,9
390,7de36bfb-7329-410a-a618-ec862a03accd,42810724,0,0,0,14
390,7de36bfb-7329-410a-a618-ec862a03accd,42809865,472,54,418,0
390,7de36bfb-7329-410a-a618-ec862a03accd,42809865,1871,573,1298,1
390,17a10ba1-03be-4756-8c50-0e2cf0c4ec10,42810724,3819,1,3818,0
390,17a10ba1-03be-4756-8c50-0e2cf0c4ec10,42810724,11265,3847,7418,1
390,17a10ba1-03be-4756-8c50-0e2cf0c4ec10,42810724,17819,11384,6435,2
390,17a10ba1-03be-4756-8c50-0e2cf0c4ec10,42810724,23616,17874,5742,3
390,17a10ba1-03be-4756-8c50-0e2cf0c4ec10,42810724,23529,21738,-1791,4
390,17a10ba1-03be-4756-8c50-0e2cf0c4ec10,42810724,21613,18927,-2686,5
390,17a10ba1-03be-4756-8c50-0e2cf0c4ec10,42811433,1374,27,1347,0
390,17a10ba1-03be-4756-8c50-0e2cf0c4ec10,42811433,3237,1426,1811,1
390,17a10ba1-03be-4756-8c50-0e2cf0c4ec10,42811433,3232,2784,-448,2
390,17a10ba1-03be-4756-8c50-0e2cf0c4ec10,42811433,2749,993,-1756,3
390,17a10ba1-03be-4756-8c50-0e2cf0c4ec10,42811433,962,619,-343,4
390,f5ab7dff-d63e-474a-b69b-f1c66ae5be10,42805712,1608,11,1597,0
390,f5ab7dff-d63e-474a-b69b-f1c66ae5be10,42805712,3697,1649,2048,1
390,f5ab7dff-d63e-474a-b69b-f1c66ae5be10,42805712,5052,3698,1354,2
390,f5ab7dff-d63e-474a-b69b-f1c66ae5be10,42805712,4893,4734,-159,3
390,f5ab7dff-d63e-474a-b69b-f1c66ae5be10,42805712,4610,878,-3732,4
390,f5ab7dff-d63e-474a-b69b-f1c66ae5be10,42805712,844,0,-844,5
390,f5ab7dff-d63e-474a-b69b-f1c66ae5be10,42805712,81,2,79,6
390,f5ab7dff-d63e-474a-b69b-f1c66ae5be10,42805712,341,82,259,7
390,f5ab7dff-d63e-474a-b69b-f1c66ae5be10,42805712,878,342,536,8
390,f5ab7dff-d63e-474a-b69b-f1c66ae5be10,42805712,2780,889,1891,9
390,f5ab7dff-d63e-474a-b69b-f1c66ae5be10,42805712,4145,2797,1348,10
390,f5ab7dff-d63e-474a-b69b-f1c66ae5be10,42805712,5052,4178,874,11
390,f5ab7dff-d63e-474a-b69b-f1c66ae5be10,42805712,5032,4230,-802,12
390,f5ab7dff-d63e-474a-b69b-f1c66ae5be10,42805712,4144,709,-3435,13
390,f5ab7dff-d63e-474a-b69b-f1c66ae5be10,42805712,676,0,-676,14
390,f5ab7dff-d63e-474a-b69b-f1c66ae5be10,42810724,179,3,176,0
390,f5ab7dff-d63e-474a-b69b-f1c66ae5be10,42810724,373,180,193,1
390,f5ab7dff-d63e-474a-b69b-f1c66ae5be10,42810724,1319,378,941,2
390,f5ab7dff-d63e-474a-b69b-f1c66ae5be10,42810724,3392,1340,2052,3
390,f5ab7dff-d63e-474a-b69b-f1c66ae5be10,42810724,6092,3510,2582,4
390,f5ab7dff-d63e-474a-b69b-f1c66ae5be10,42810724,9561,6147,3414,5
390,f5ab7dff-d63e-474a-b69b-f1c66ae5be10,42810724,16294,9586,6708,6
390,f5ab7dff-d63e-474a-b69b-f1c66ae5be10,42810724,21526,16398,5128,7
390,f5ab7dff-d63e-474a-b69b-f1c66ae5be10,42810724,23616,21730,1886,8
390,f5ab7dff-d63e-474a-b69b-f1c66ae5be10,42810724,22770,22295,-475,9
390,f5ab7dff-d63e-474a-b69b-f1c66ae5be10,42810724,22252,21446,-806,10
390,f5ab7dff-d63e-474a-b69b-f1c66ae5be10,42810724,21442,21343,-99,11
390,f5ab7dff-d63e-474a-b69b-f1c66ae5be10,42810724,21342,20579,-763,12
390,f5ab7dff-d63e-474a-b69b-f1c66ae5be10,42810724,20565,20159,-406,13
390,f5ab7dff-d63e-474a-b69b-f1c66ae5be10,42810724,20839,20182,-657,14
390,f5ab7dff-d63e-474a-b69b-f1c66ae5be10,42810724,20422,19628,794,15
390,f5ab7dff-d63e-474a-b69b-f1c66ae5be10,42810724,21085,20163,-922,16
390,f5ab7dff-d63e-474a-b69b-f1c66ae5be10,42810724,21407,20020,1387,17
390,f5ab7dff-d63e-474a-b69b-f1c66ae5be10,42810724,21731,21050,-681,18
389,98255014-39d5-42a5-a5de-7494ec313ee7,42812158,164,2,162,0
389,98255014-39d5-42a5-a5de-7494ec313ee7,42812158,226,172,54,1
389,98255014-39d5-42a5-a5de-7494ec313ee7,42812158,654,240,414,7
389,98255014-39d5-42a5-a5de-7494ec313ee7,42812158,722,666,56,8
389,98255014-39d5-42a5-a5de-7494ec313ee7,42812158,863,723,140,17
389,98255014-39d5-42a5-a5de-7494ec313ee7,42812158,942,870,72,18
389,98255014-39d5-42a5-a5de-7494ec313ee7,42812158,1082,950,132,25
389,98255014-39d5-42a5-a5de-7494ec313ee7,42812158,1084,1083,1,26
389,98255014-39d5-42a5-a5de-7494ec313ee7,42812158,1157,1085,72,31
389,98255014-39d5-42a5-a5de-7494ec313ee7,42812158,1174,1161,13,32
389,98255014-39d5-42a5-a5de-7494ec313ee7,42812158,1179,1179,0,36
389,98255014-39d5-42a5-a5de-7494ec313ee7,42812158,1290,1187,103,37
389,98255014-39d5-42a5-a5de-7494ec313ee7,42812158,1304,1292,12,38
389,98255014-39d5-42a5-a5de-7494ec313ee7,42812158,1306,1305,-1,39
389,98255014-39d5-42a5-a5de-7494ec313ee7,42812158,1306,1305,1,39
389,98255014-39d5-42a5-a5de-7494ec313ee7,42812158,1462,1308,154,53
389,98255014-39d5-42a5-a5de-7494ec313ee7,42812158,1558,1468,90,54
389,98255014-39d5-42a5-a5de-7494ec313ee7,42812158,1692,1566,126,55
389,98255014-39d5-42a5-a5de-7494ec313ee7,42812158,1780,1693,87,56
389,98255014-39d5-42a5-a5de-7494ec313ee7,42812158,1933,1790,143,57
389,98255014-39d5-42a5-a5de-7494ec313ee7,42812158,2008,1935,73,58
389,98255014-39d5-42a5-a5de-7494ec313ee7,42812158,2061,2009,52,59
389,98255014-39d5-42a5-a5de-7494ec313ee7,42812158,2131,2062,69,60
389,98255014-39d5-42a5-a5de-7494ec313ee7,42812158,2135,2132,3,61
389,98255014-39d5-42a5-a5de-7494ec313ee7,42812158,2293,2139,154,86
389,98255014-39d5-42a5-a5de-7494ec313ee7,42812158,2604,2297,307,107
389,98255014-39d5-42a5-a5de-7494ec313ee7,42812158,2788,2613,175,108
389,98255014-39d5-42a5-a5de-7494ec313ee7,42812158,2825,2789,36,109
389,98255014-39d5-42a5-a5de-7494ec313ee7,42812158,3115,2839,276,125
389,98255014-39d5-42a5-a5de-7494ec313ee7,42812158,3117,3116,-1,126
389,98255014-39d5-42a5-a5de-7494ec313ee7,42812158,3466,3118,348,152
389,98255014-39d5-42a5-a5de-7494ec313ee7,42812158,3501,3468,33,153
389,98255014-39d5-42a5-a5de-7494ec313ee7,42812158,3509,3509,0,162
389,98255014-39d5-42a5-a5de-7494ec313ee7,42812158,3689,3522,167,163
389,98255014-39d5-42a5-a5de-7494ec313ee7,42812158,3656,2752,-904,14626
389,98255014-39d5-42a5-a5de-7494ec313ee7,42812158,2690,1587,-1103,14627
389,98255014-39d5-42a5-a5de-7494ec313ee7,42812158,1586,1566,-20,14628
389,98255014-39d5-42a5-a5de-7494ec313ee7,42812158,1567,1567,0,14629
385,98f10109-a707-4dc0-a65f-ed55a0f4e5f4,42827210,751,30,721,0
385,98f10109-a707-4dc0-a65f-ed55a0f4e5f4,42827210,971,766,205,6
385,98f10109-a707-4dc0-a65f-ed55a0f4e5f4,42827210,2145,984,1161,13
385,98f10109-a707-4dc0-a65f-ed55a0f4e5f4,42827210,2173,2151,22,14
385,98f10109-a707-4dc0-a65f-ed55a0f4e5f4,42827210,2343,2190,153,18
385,98f10109-a707-4dc0-a65f-ed55a0f4e5f4,42827210,2826,2374,452,34
385,98f10109-a707-4dc0-a65f-ed55a0f4e5f4,42827210,3334,2842,492,37
385,98f10109-a707-4dc0-a65f-ed55a0f4e5f4,42827210,3338,3336,2,38
385,98f10109-a707-4dc0-a65f-ed55a0f4e5f4,42827210,3868,3372,496,43
385,98f10109-a707-4dc0-a65f-ed55a0f4e5f4,42827210,4280,3875,405,46
385,98f10109-a707-4dc0-a65f-ed55a0f4e5f4,42825431,394,18,376,0
385,98f10109-a707-4dc0-a65f-ed55a0f4e5f4,42825431,687,436,251,1
385,98f10109-a707-4dc0-a65f-ed55a0f4e5f4,42825431,879,724,155,13
385,98f10109-a707-4dc0-a65f-ed55a0f4e5f4,42825431,975,890,85,14
385,98f10109-a707-4dc0-a65f-ed55a0f4e5f4,42825431,1113,1021,92,17
385,98f10109-a707-4dc0-a65f-ed55a0f4e5f4,42825431,1447,1172,275,18
385,98f10109-a707-4dc0-a65f-ed55a0f4e5f4,42825431,1555,1502,53,24
385,98f10109-a707-4dc0-a65f-ed55a0f4e5f4,42825431,2132,1606,526,25
385,98f10109-a707-4dc0-a65f-ed55a0f4e5f4,42825431,2657,2161,496,34
385,98f10109-a707-4dc0-a65f-ed55a0f4e5f4,42825431,3752,2675,1077,38
385,98f10109-a707-4dc0-a65f-ed55a0f4e5f4,42825431,3844,3778,66,39
385,98f10109-a707-4dc0-a65f-ed55a0f4e5f4,42825431,3870,3870,0,54
385,98f10109-a707-4dc0-a65f-ed55a0f4e5f4,42825431,5179,3909,1270,55
385,98f10109-a707-4dc0-a65f-ed55a0f4e5f4,42825431,5419,5197,222,56
385,98f10109-a707-4dc0-a65f-ed55a0f4e5f4,42826028,68,28,40,0
385,98f10109-a707-4dc0-a65f-ed55a0f4e5f4,42826028,433,0,-433,1
385,98f10109-a707-4dc0-a65f-ed55a0f4e5f4,42826028,612,18,594,2
385,98f10109-a707-4dc0-a65f-ed55a0f4e5f4,42826028,836,633,203,8
385,98f10109-a707-4dc0-a65f-ed55a0f4e5f4,42826028,1146,859,287,11
385,98f10109-a707-4dc0-a65f-ed55a0f4e5f4,42826028,1480,1161,319,16
385,98f10109-a707-4dc0-a65f-ed55a0f4e5f4,42826028,1796,1501,295,21
385,98f10109-a707-4dc0-a65f-ed55a0f4e5f4,42826028,1943,1808,135,22
385,98f10109-a707-4dc0-a65f-ed55a0f4e5f4,42826028,2192,1986,206,23
385,98f10109-a707-4dc0-a65f-ed55a0f4e5f4,42826028,2167,1748,-419,27
385,98f10109-a707-4dc0-a65f-ed55a0f4e5f4,42826028,2437,1781,656,28
385,98f10109-a707-4dc0-a65f-ed55a0f4e5f4,42826028,2649,2443,206,30
385,98f10109-a707-4dc0-a65f-ed55a0f4e5f4,42826028,2650,2650,0,31
385,98f10109-a707-4dc0-a65f-ed55a0f4e5f4,42826028,2925,2693,232,41
385,98f10109-a707-4dc0-a65f-ed55a0f4e5f4,42826915,74,35,39,0
385,98f10109-a707-4dc0-a65f-ed55a0f4e5f4,42826915,916,120,796,1
385,98f10109-a707-4dc0-a65f-ed55a0f4e5f4,42826915,1574,947,627,12
385,98f10109-a707-4dc0-a65f-ed55a0f4e5f4,42826915,1785,1602,183,13
385,98f10109-a707-4dc0-a65f-ed55a0f4e5f4,42821938,1027,24,1003,0
385,98f10109-a707-4dc0-a65f-ed55a0f4e5f4,42821938,1397,980,-417,1
385,98f10109-a707-4dc0-a65f-ed55a0f4e5f4,42821938,1486,1022,464,16
385,98f10109-a707-4dc0-a65f-ed55a0f4e5f4,42821938,1854,1515,339,20
385,98f10109-a707-4dc0-a65f-ed55a0f4e5f4,42821938,2253,1874,379,28
385,98f10109-a707-4dc0-a65f-ed55a0f4e5f4,42821938,3317,2295,1022,29
385,98f10109-a707-4dc0-a65f-ed55a0f4e5f4,42821938,3804,3359,445,30
385,98f10109-a707-4dc0-a65f-ed55a0f4e5f4,42820246,85,47,38,0
385,98f10109-a707-4dc0-a65f-ed55a0f4e5f4,42820246,685,125,560,1
385,98f10109-a707-4dc0-a65f-ed55a0f4e5f4,42820246,863,693,170,20
385,98f10109-a707-4dc0-a65f-ed55a0f4e5f4,42820246,1360,879,481,35
385,98f10109-a707-4dc0-a65f-ed55a0f4e5f4,42820246,1608,1391,217,40
385,98f10109-a707-4dc0-a65f-ed55a0f4e5f4,42820246,1810,1642,168,41
385,98f10109-a707-4dc0-a65f-ed55a0f4e5f4,42820246,2482,1835,647,45
385,98f10109-a707-4dc0-a65f-ed55a0f4e5f4,42820246,2507,2488,19,46
385,98f10109-a707-4dc0-a65f-ed55a0f4e5f4,42820246,2962,2513,449,49
385,98f10109-a707-4dc0-a65f-ed55a0f4e5f4,42820246,3748,2971,777,69
385,98f10109-a707-4dc0-a65f-ed55a0f4e5f4,42820246,4131,3749,382,70
389,98255014-39d5-42a5-a5de-7494ec313ee7,42819405,282,10,272,0
389,98255014-39d5-42a5-a5de-7494ec313ee7,42819405,288,284,4,1
389,98255014-39d5-42a5-a5de-7494ec313ee7,42819405,656,311,345,87
389,98255014-39d5-42a5-a5de-7494ec313ee7,42819405,856,661,195,88
389,98255014-39d5-42a5-a5de-7494ec313ee7,42819405,873,858,15,89
389,98255014-39d5-42a5-a5de-7494ec313ee7,42819405,871,871,0,90
389,98255014-39d5-42a5-a5de-7494ec313ee7,42819405,934,872,62,91
389,98255014-39d5-42a5-a5de-7494ec313ee7,42819405,1004,940,64,92
389,98255014-39d5-42a5-a5de-7494ec313ee7,42819405,1008,1005,3,93
389,98255014-39d5-42a5-a5de-7494ec313ee7,42819405,1042,1009,33,94
389,98255014-39d5-42a5-a5de-7494ec313ee7,42819405,1064,1041,23,95
389,98255014-39d5-42a5-a5de-7494ec313ee7,42819405,1103,1065,38,96
389,98255014-39d5-42a5-a5de-7494ec313ee7,42819405,1106,1104,2,97
389,98255014-39d5-42a5-a5de-7494ec313ee7,42819405,1117,1107,10,98
389,98255014-39d5-42a5-a5de-7494ec313ee7,42819405,1151,1118,33,99
389,98255014-39d5-42a5-a5de-7494ec313ee7,42819405,1235,1153,82,100
389,98255014-39d5-42a5-a5de-7494ec313ee7,42819405,1489,1236,253,107
389,98255014-39d5-42a5-a5de-7494ec313ee7,42819405,2076,1490,586,108
389,98255014-39d5-42a5-a5de-7494ec313ee7,42819405,2054,1894,-160,109
389,59fee2e6-e8d2-462f-991d-139820ab7970,42831507,134,16,118,0
389,59fee2e6-e8d2-462f-991d-139820ab7970,42831507,375,151,224,1
389,59fee2e6-e8d2-462f-991d-139820ab7970,42831507,536,383,153,2
389,59fee2e6-e8d2-462f-991d-139820ab7970,42831507,579,546,33,27
389,59fee2e6-e8d2-462f-991d-139820ab7970,42831507,743,593,150,28
389,59fee2e6-e8d2-462f-991d-139820ab7970,42831507,761,744,17,29
389,59fee2e6-e8d2-462f-991d-139820ab7970,42831507,764,763,1,30
389,59fee2e6-e8d2-462f-991d-139820ab7970,42831507,767,765,2,32
389,59fee2e6-e8d2-462f-991d-139820ab7970,42831507,796,768,28,52
389,59fee2e6-e8d2-462f-991d-139820ab7970,42831507,883,804,79,54
389,59fee2e6-e8d2-462f-991d-139820ab7970,42831507,877,736,-141,55
389,59fee2e6-e8d2-462f-991d-139820ab7970,42831507,803,741,62,62
389,59fee2e6-e8d2-462f-991d-139820ab7970,42831507,804,804,0,66
389,59fee2e6-e8d2-462f-991d-139820ab7970,42831507,811,802,9,67
389,59fee2e6-e8d2-462f-991d-139820ab7970,42831507,876,812,64,68
389,59fee2e6-e8d2-462f-991d-139820ab7970,42831507,875,874,1,69
389,59fee2e6-e8d2-462f-991d-139820ab7970,42831507,1240,877,363,92
389,59fee2e6-e8d2-462f-991d-139820ab7970,42831507,1458,1257,201,93
389,318570ab-c3c5-4393-bf0c-40a5cecc1e74,42826915,229,23,206,0
389,318570ab-c3c5-4393-bf0c-40a5cecc1e74,42821938,752,21,731,0
389,90e17a0c-329b-4af7-9fe3-237c6b01bbf5,42851668,190,13,177,0
389,90e17a0c-329b-4af7-9fe3-237c6b01bbf5,42851668,324,211,113,1
389,90e17a0c-329b-4af7-9fe3-237c6b01bbf5,42851668,572,323,249,2
389,90e17a0c-329b-4af7-9fe3-237c6b01bbf5,42851668,617,573,44,3
389,90e17a0c-329b-4af7-9fe3-237c6b01bbf5,42851668,653,620,33,4
389,90e17a0c-329b-4af7-9fe3-237c6b01bbf5,42851668,673,654,19,5
389,90e17a0c-329b-4af7-9fe3-237c6b01bbf5,42851668,755,674,81,6
389,90e17a0c-329b-4af7-9fe3-237c6b01bbf5,42851668,836,763,73,7
389,90e17a0c-329b-4af7-9fe3-237c6b01bbf5,42851668,843,837,6,8
389,90e17a0c-329b-4af7-9fe3-237c6b01bbf5,42851668,856,844,12,9
389,90e17a0c-329b-4af7-9fe3-237c6b01bbf5,42851668,883,857,26,10
389,90e17a0c-329b-4af7-9fe3-237c6b01bbf5,42851668,899,884,15,11
389,90e17a0c-329b-4af7-9fe3-237c6b01bbf5,42851668,996,900,96,12
389,90e17a0c-329b-4af7-9fe3-237c6b01bbf5,42851668,998,996,-2,13
389,90e17a0c-329b-4af7-9fe3-237c6b01bbf5,42851668,916,0,-916,98954
401,9848fff2-7044-40f2-bc9c-123f4b0f9873,43439807,202,14,188,0
401,9848fff2-7044-40f2-bc9c-123f4b0f9873,43439807,470,214,256,1
401,9848fff2-7044-40f2-bc9c-123f4b0f9873,43439807,716,479,237,9
401,9848fff2-7044-40f2-bc9c-123f4b0f9873,43439807,754,722,32,10
401,9848fff2-7044-40f2-bc9c-123f4b0f9873,43439807,1171,779,392,17
401,9848fff2-7044-40f2-bc9c-123f4b0f9873,43439807,1193,1173,20,18
401,9848fff2-7044-40f2-bc9c-123f4b0f9873,43439807,1552,1205,347,27
401,9848fff2-7044-40f2-bc9c-123f4b0f9873,43439807,1577,1555,22,28
401,9848fff2-7044-40f2-bc9c-123f4b0f9873,43439807,1999,1580,419,30
401,9848fff2-7044-40f2-bc9c-123f4b0f9873,43439807,2428,2009,419,40
401,9848fff2-7044-40f2-bc9c-123f4b0f9873,43439807,2951,2449,502,50
401,9848fff2-7044-40f2-bc9c-123f4b0f9873,43439807,3644,2965,679,55
401,9848fff2-7044-40f2-bc9c-123f4b0f9873,43439807,4080,3665,415,57
401,9848fff2-7044-40f2-bc9c-123f4b0f9873,43439807,4168,4095,73,58
401,9848fff2-7044-40f2-bc9c-123f4b0f9873,43439807,4657,4191,466,66
401,9848fff2-7044-40f2-bc9c-123f4b0f9873,43439807,4726,4667,59,67
401,9848fff2-7044-40f2-bc9c-123f4b0f9873,43439807,5140,4735,405,80
401,9848fff2-7044-40f2-bc9c-123f4b0f9873,43439807,5306,5152,154,81
401,9848fff2-7044-40f2-bc9c-123f4b0f9873,43439807,5984,5323,661,91
401,9848fff2-7044-40f2-bc9c-123f4b0f9873,43439807,6637,6006,631,98
401,9848fff2-7044-40f2-bc9c-123f4b0f9873,43439807,6642,6639,3,99
401,9848fff2-7044-40f2-bc9c-123f4b0f9873,43439807,7120,6655,465,100
401,9848fff2-7044-40f2-bc9c-123f4b0f9873,43439807,7775,7136,639,129
401,9848fff2-7044-40f2-bc9c-123f4b0f9873,43439807,7936,7800,136,130
401,9848fff2-7044-40f2-bc9c-123f4b0f9873,43439807,8397,7958,439,142
401,9848fff2-7044-40f2-bc9c-123f4b0f9873,43439807,9238,8452,786,143
401,9848fff2-7044-40f2-bc9c-123f4b0f9873,43439807,9684,9255,429,149
401,9848fff2-7044-40f2-bc9c-123f4b0f9873,43439807,9834,9708,126,150
401,9848fff2-7044-40f2-bc9c-123f4b0f9873,43444791,207,13,194,0
401,9848fff2-7044-40f2-bc9c-123f4b0f9873,43444791,724,221,503,1
401,9848fff2-7044-40f2-bc9c-123f4b0f9873,43444791,768,730,38,2
401,9848fff2-7044-40f2-bc9c-123f4b0f9873,43444791,932,769,163,21
401,9848fff2-7044-40f2-bc9c-123f4b0f9873,43444791,1474,951,523,22
401,9848fff2-7044-40f2-bc9c-123f4b0f9873,43444791,1998,1511,487,41
401,9848fff2-7044-40f2-bc9c-123f4b0f9873,43444791,2246,2004,242,48
401,9848fff2-7044-40f2-bc9c-123f4b0f9873,43444791,2393,2269,124,49
401,9848fff2-7044-40f2-bc9c-123f4b0f9873,43444791,2600,2423,177,55
401,9848fff2-7044-40f2-bc9c-123f4b0f9873,43444791,3067,2619,448,56
401,9848fff2-7044-40f2-bc9c-123f4b0f9873,43444791,3608,3107,501,84
401,9848fff2-7044-40f2-bc9c-123f4b0f9873,43444791,3615,3611,4,85
401,9848fff2-7044-40f2-bc9c-123f4b0f9873,43444791,4001,3619,382,102
401,9848fff2-7044-40f2-bc9c-123f4b0f9873,43444791,4083,4013,70,103
401,9848fff2-7044-40f2-bc9c-123f4b0f9873,43444791,4419,4092,327,121
401,9848fff2-7044-40f2-bc9c-123f4b0f9873,43444791,4489,4426,63,122
401,9848fff2-7044-40f2-bc9c-123f4b0f9873,43444791,4989,4505,484,131
401,9848fff2-7044-40f2-bc9c-123f4b0f9873,43444791,5501,5008,493,142
401,9848fff2-7044-40f2-bc9c-123f4b0f9873,43444791,5641,5524,117,159
401,9848fff2-7044-40f2-bc9c-123f4b0f9873,43444791,5901,5679,222,160
401,9848fff2-7044-40f2-bc9c-123f4b0f9873,43428003,382,42,340,0
401,9848fff2-7044-40f2-bc9c-123f4b0f9873,43428003,560,403,157,1
401,9848fff2-7044-40f2-bc9c-123f4b0f9873,43428003,879,565,314,21
401,9848fff2-7044-40f2-bc9c-123f4b0f9873,43428003,1318,889,429,26
401,9848fff2-7044-40f2-bc9c-123f4b0f9873,43428003,1431,1354,77,44
401,9848fff2-7044-40f2-bc9c-123f4b0f9873,43429393,470,23,447,0
401,9848fff2-7044-40f2-bc9c-123f4b0f9873,43429393,1000,509,491,9
401,9848fff2-7044-40f2-bc9c-123f4b0f9873,43429393,1004,1002,2,10
401,9848fff2-7044-40f2-bc9c-123f4b0f9873,43429393,1706,1016,690,18
401,9848fff2-7044-40f2-bc9c-123f4b0f9873,43429393,1900,1709,191,29
401,9848fff2-7044-40f2-bc9c-123f4b0f9873,43429393,2034,1913,121,30
401,9848fff2-7044-40f2-bc9c-123f4b0f9873,43429393,2461,2052,409,35
401,9848fff2-7044-40f2-bc9c-123f4b0f9873,43429393,2591,2481,110,50
401,9848fff2-7044-40f2-bc9c-123f4b0f9873,43429393,3169,2610,559,51
401,9848fff2-7044-40f2-bc9c-123f4b0f9873,43429393,3624,3187,437,57
401,9848fff2-7044-40f2-bc9c-123f4b0f9873,43429393,4103,3628,475,70
401,9848fff2-7044-40f2-bc9c-123f4b0f9873,43429393,4149,4111,38,71
401,9848fff2-7044-40f2-bc9c-123f4b0f9873,43429393,4618,4181,437,82
401,9848fff2-7044-40f2-bc9c-123f4b0f9873,43429393,4716,4633,83,83
401,9848fff2-7044-40f2-bc9c-123f4b0f9873,43429393,5136,4755,381,94
401,9848fff2-7044-40f2-bc9c-123f4b0f9873,43429393,5382,5144,238,95
401,9848fff2-7044-40f2-bc9c-123f4b0f9873,43429393,5817,5415,402,105
401,2c8edaba-2387-4a58-bd43-2ef1b3e09139,43446359,151,6,145,0
401,2c8edaba-2387-4a58-bd43-2ef1b3e09139,43446359,818,175,643,1
401,2c8edaba-2387-4a58-bd43-2ef1b3e09139,43446359,860,820,40,2
401,2c8edaba-2387-4a58-bd43-2ef1b3e09139,43446359,1717,861,856,18
401,2c8edaba-2387-4a58-bd43-2ef1b3e09139,43446359,1763,1718,45,19
401,2c8edaba-2387-4a58-bd43-2ef1b3e09139,43446359,2440,1768,672,41
401,2c8edaba-2387-4a58-bd43-2ef1b3e09139,43446359,2520,2451,69,42
401,2c8edaba-2387-4a58-bd43-2ef1b3e09139,43446359,2736,2526,210,65
401,2c8edaba-2387-4a58-bd43-2ef1b3e09139,43446359,3312,2759,553,66
401,2c8edaba-2387-4a58-bd43-2ef1b3e09139,43446359,3890,3320,570,80
401,2c8edaba-2387-4a58-bd43-2ef1b3e09139,43446359,3945,3898,47,81
401,d4c50aa8-bd19-45b8-ba05-83f01547f7ea,43455480,617,23,594,0
401,d4c50aa8-bd19-45b8-ba05-83f01547f7ea,43455480,854,619,235,15
401,d4c50aa8-bd19-45b8-ba05-83f01547f7ea,43455480,1349,885,464,16
401,d4c50aa8-bd19-45b8-ba05-83f01547f7ea,43455480,1366,1351,15,17
401,d4c50aa8-bd19-45b8-ba05-83f01547f7ea,43455480,1973,1393,580,22
401,d4c50aa8-bd19-45b8-ba05-83f01547f7ea,43455480,2547,1989,558,33
401,d4c50aa8-bd19-45b8-ba05-83f01547f7ea,43455480,2730,2568,162,34
401,d4c50aa8-bd19-45b8-ba05-83f01547f7ea,43455480,3512,2741,771,45
401,d4c50aa8-bd19-45b8-ba05-83f01547f7ea,43455480,3517,3514,3,46
401,d4c50aa8-bd19-45b8-ba05-83f01547f7ea,43455480,4279,3564,715,61
401,f4b53eea-948c-44c1-a626-a8f60f7534bc,43437097,593,102,491,0
401,f4b53eea-948c-44c1-a626-a8f60f7534bc,43437097,752,629,123,1
401,f4b53eea-948c-44c1-a626-a8f60f7534bc,43437097,1244,775,469,13
401,f4b53eea-948c-44c1-a626-a8f60f7534bc,43437097,1246,1246,0,14
401,f4b53eea-948c-44c1-a626-a8f60f7534bc,43437097,1673,1284,389,28
401,f4b53eea-948c-44c1-a626-a8f60f7534bc,43437097,1992,1692,300,29
401,f4b53eea-948c-44c1-a626-a8f60f7534bc,43437097,2156,2037,119,42
401,f4b53eea-948c-44c1-a626-a8f60f7534bc,43437097,2316,2184,132,43
401,1fc400f7-e671-41d4-a145-6eb1a7856ca8,43462423,748,208,540,0
401,1fc400f7-e671-41d4-a145-6eb1a7856ca8,43462423,1437,754,683,13
401,1fc400f7-e671-41d4-a145-6eb1a7856ca8,43462423,1442,1438,4,14
401,1fc400f7-e671-41d4-a145-6eb1a7856ca8,43462423,2147,1449,698,24
401,1fc400f7-e671-41d4-a145-6eb1a7856ca8,43462423,2649,2175,474,33
401,1fc400f7-e671-41d4-a145-6eb1a7856ca8,43435689,569,20,549,0
401,1fc400f7-e671-41d4-a145-6eb1a7856ca8,43435689,1096,627,469,6
401,1fc400f7-e671-41d4-a145-6eb1a7856ca8,43435689,1240,1113,127,7
401,1fc400f7-e671-41d4-a145-6eb1a7856ca8,43435689,2026,1284,742,21
401,1fc400f7-e671-41d4-a145-6eb1a7856ca8,43435689,2713,2043,670,31
401,1fc400f7-e671-41d4-a145-6eb1a7856ca8,43435689,2712,2712,0,32
401,1fc400f7-e671-41d4-a145-6eb1a7856ca8,43435689,3092,2729,363,46
401,1fc400f7-e671-41d4-a145-6eb1a7856ca8,43435689,3419,3111,308,47
401,1fc400f7-e671-41d4-a145-6eb1a7856ca8,43435689,3764,3431,333,64
401,1fc400f7-e671-41d4-a145-6eb1a7856ca8,43435689,4019,3783,236,65
401,1fc400f7-e671-41d4-a145-6eb1a7856ca8,43435689,4645,4034,611,69
401,1fc400f7-e671-41d4-a145-6eb1a7856ca8,43435689,4685,4655,30,70
401,1fc400f7-e671-41d4-a145-6eb1a7856ca8,43435689,5299,4694,605,77
401,1fc400f7-e671-41d4-a145-6eb1a7856ca8,43435689,5520,5327,193,80
401,ddb6d59b-038d-41da-81fa-00d84487081c,43465700,565,209,356,0
401,ddb6d59b-038d-41da-81fa-00d84487081c,43465700,1250,574,676,7
401,ddb6d59b-038d-41da-81fa-00d84487081c,43465700,1539,1272,267,8
401,ddb6d59b-038d-41da-81fa-00d84487081c,43465700,2277,1556,721,34
401,ddb6d59b-038d-41da-81fa-00d84487081c,43465700,2291,2281,10,35
401,ddb6d59b-038d-41da-81fa-00d84487081c,43465700,2552,2341,211,52
401,ddb6d59b-038d-41da-81fa-00d84487081c,43465700,2918,2578,340,53
401,ddb6d59b-038d-41da-81fa-00d84487081c,43465700,3584,2943,641,70
401,ddb6d59b-038d-41da-81fa-00d84487081c,43465700,4374,3590,784,91
401,ddb6d59b-038d-41da-81fa-00d84487081c,43465700,4684,4410,274,92
401,ddb6d59b-038d-41da-81fa-00d84487081c,43465700,5338,4689,649,123
401,ddb6d59b-038d-41da-81fa-00d84487081c,43465700,5407,5358,49,124
401,ddb6d59b-038d-41da-81fa-00d84487081c,43465700,6192,5438,754,133
401,ddb6d59b-038d-41da-81fa-00d84487081c,43465700,6613,6199,414,146
401,ddb6d59b-038d-41da-81fa-00d84487081c,43465700,7012,6620,392,147
401,ddb6d59b-038d-41da-81fa-00d84487081c,43465700,7011,7011,0,148
401,ddb6d59b-038d-41da-81fa-00d84487081c,43465700,7764,7030,734,168
401,ddb6d59b-038d-41da-81fa-00d84487081c,43465700,8853,7824,1029,187
401,ddb6d59b-038d-41da-81fa-00d84487081c,43465700,8941,8859,82,189
401,ddb6d59b-038d-41da-81fa-00d84487081c,43465700,9595,8963,632,190
401,ddb6d59b-038d-41da-81fa-00d84487081c,43465700,10065,9604,461,191
401,9cb4c17c-557a-4651-bce6-1ee14bcd7355,43494337,150,12,138,0
401,9cb4c17c-557a-4651-bce6-1ee14bcd7355,43494337,492,186,306,1
401,9cb4c17c-557a-4651-bce6-1ee14bcd7355,43494337,674,502,172,10
401,9cb4c17c-557a-4651-bce6-1ee14bcd7355,43494337,765,684,81,11
401,9cb4c17c-557a-4651-bce6-1ee14bcd7355,43494337,1042,785,257,16
401,9cb4c17c-557a-4651-bce6-1ee14bcd7355,43494337,1866,1065,801,25
401,9cb4c17c-557a-4651-bce6-1ee14bcd7355,43494337,2238,1869,369,26
401,9cb4c17c-557a-4651-bce6-1ee14bcd7355,43494337,2645,2284,361,37
401,9cb4c17c-557a-4651-bce6-1ee14bcd7355,43494337,2660,2650,10,38
401,9cb4c17c-557a-4651-bce6-1ee14bcd7355,43494337,3278,2679,599,43
401,9cb4c17c-557a-4651-bce6-1ee14bcd7355,43494337,3279,3279,0,44
401,9cb4c17c-557a-4651-bce6-1ee14bcd7355,43494337,3446,3303,143,49
401,9cb4c17c-557a-4651-bce6-1ee14bcd7355,43494337,3743,3464,279,50
401,9cb4c17c-557a-4651-bce6-1ee14bcd7355,43494337,4037,3760,277,55
401,9cb4c17c-557a-4651-bce6-1ee14bcd7355,43494337,4114,4048,66,56
401,9cb4c17c-557a-4651-bce6-1ee14bcd7355,43494337,4577,4125,452,66
401,9cb4c17c-557a-4651-bce6-1ee14bcd7355,43494337,4814,4585,229,68
401,9cb4c17c-557a-4651-bce6-1ee14bcd7355,43494337,5141,4830,311,73
401,9cb4c17c-557a-4651-bce6-1ee14bcd7355,43494337,5153,5143,10,74
401,9cb4c17c-557a-4651-bce6-1ee14bcd7355,43494337,5637,5166,471,82
401,9cb4c17c-557a-4651-bce6-1ee14bcd7355,43494337,6277,5652,625,91
401,9cb4c17c-557a-4651-bce6-1ee14bcd7355,43494337,6628,6288,340,92
401,9cb4c17c-557a-4651-bce6-1ee14bcd7355,43494337,6858,6677,181,93
401,9cb4c17c-557a-4651-bce6-1ee14bcd7355,43494337,7231,6843,388,105
401,9cb4c17c-557a-4651-bce6-1ee14bcd7355,43494337,7903,7248,655,119
401,9cb4c17c-557a-4651-bce6-1ee14bcd7355,43494337,8155,7920,235,127
401,9cb4c17c-557a-4651-bce6-1ee14bcd7355,43494337,8521,8166,355,128
401,9cb4c17c-557a-4651-bce6-1ee14bcd7355,43494337,9251,8544,707,135
401,9cb4c17c-557a-4651-bce6-1ee14bcd7355,43494337,9707,9287,420,150
401,9cb4c17c-557a-4651-bce6-1ee14bcd7355,43494337,9871,9713,158,151
401,9cb4c17c-557a-4651-bce6-1ee14bcd7355,43494337,10551,9885,666,156
401,9cb4c17c-557a-4651-bce6-1ee14bcd7355,43494337,10688,10561,127,157
401,9cb4c17c-557a-4651-bce6-1ee14bcd7355,43494337,11024,10713,311,175
401,9cb4c17c-557a-4651-bce6-1ee14bcd7355,43494337,11251,11051,200,176
401,9cb4c17c-557a-4651-bce6-1ee14bcd7355,43494337,11471,11257,214,177
401,9cb4c17c-557a-4651-bce6-1ee14bcd7355,43494337,11630,11473,157,178
402,f266e40f-4ee6-4aed-9c87-82a038010700,43633094,243,11,232,0
402,f266e40f-4ee6-4aed-9c87-82a038010700,43633094,416,265,151,1
402,f266e40f-4ee6-4aed-9c87-82a038010700,43633094,982,404,578,8
403,32e91c0b-3b35-470e-8905-cb4307e9420a,43636379,752,33,719,0
403,32e91c0b-3b35-470e-8905-cb4307e9420a,43636379,971,767,204,1
403,32e91c0b-3b35-470e-8905-cb4307e9420a,43636379,2465,987,1478,2
403,32e91c0b-3b35-470e-8905-cb4307e9420a,43636379,2361,0,-2361,3
403,32e91c0b-3b35-470e-8905-cb4307e9420a,43636379,54,1,53,5
403,32e91c0b-3b35-470e-8905-cb4307e9420a,43636379,51,48,3,6
403,32e91c0b-3b35-470e-8905-cb4307e9420a,43636379,601,61,540,7
403,32e91c0b-3b35-470e-8905-cb4307e9420a,43636379,721,602,119,8
403,32e91c0b-3b35-470e-8905-cb4307e9420a,43636379,737,5,-732,9
403,32e91c0b-3b35-470e-8905-cb4307e9420a,43636379,156,0,156,10
403,32e91c0b-3b35-470e-8905-cb4307e9420a,43636379,734,163,571,11
403,32e91c0b-3b35-470e-8905-cb4307e9420a,43636379,910,744,166,12
403,32e91c0b-3b35-470e-8905-cb4307e9420a,43636379,1028,912,116,14
403,32e91c0b-3b35-470e-8905-cb4307e9420a,43636379,1031,1029,2,15
403,32e91c0b-3b35-470e-8905-cb4307e9420a,43636379,1174,1037,137,18
403,32e91c0b-3b35-470e-8905-cb4307e9420a,43636379,1282,1175,107,30
403,32e91c0b-3b35-470e-8905-cb4307e9420a,43636379,1451,1290,161,38
403,32e91c0b-3b35-470e-8905-cb4307e9420a,43636379,1689,1458,231,55
403,32e91c0b-3b35-470e-8905-cb4307e9420a,43636379,1728,1693,35,56
403,32e91c0b-3b35-470e-8905-cb4307e9420a,43636379,2079,1744,335,57
403,32e91c0b-3b35-470e-8905-cb4307e9420a,43636379,2202,2086,116,58
403,32e91c0b-3b35-470e-8905-cb4307e9420a,43636379,2407,2204,203,59
403,32e91c0b-3b35-470e-8905-cb4307e9420a,43636379,2538,2408,130,60
403,32e91c0b-3b35-470e-8905-cb4307e9420a,43636379,2733,2549,184,82
403,32e91c0b-3b35-470e-8905-cb4307e9420a,43636379,3241,2738,503,83
403,32e91c0b-3b35-470e-8905-cb4307e9420a,43636379,3389,3250,139,102
403,32e91c0b-3b35-470e-8905-cb4307e9420a,43636379,3473,3391,82,112
403,32e91c0b-3b35-470e-8905-cb4307e9420a,43636379,3781,3484,297,121
403,32e91c0b-3b35-470e-8905-cb4307e9420a,43636379,6105,3810,2295,123
403,32e91c0b-3b35-470e-8905-cb4307e9420a,43636379,8103,6123,1980,124
403,32e91c0b-3b35-470e-8905-cb4307e9420a,43636379,8316,8113,203,125
403,32e91c0b-3b35-470e-8905-cb4307e9420a,43636379,8281,1905,-6376,126
403,32e91c0b-3b35-470e-8905-cb4307e9420a,43636379,1852,1391,-461,127
403,32e91c0b-3b35-470e-8905-cb4307e9420a,43629255,155,9,146,0
403,32e91c0b-3b35-470e-8905-cb4307e9420a,43629255,238,164,74,8
403,32e91c0b-3b35-470e-8905-cb4307e9420a,43629255,1522,266,1256,9
403,32e91c0b-3b35-470e-8905-cb4307e9420a,43629255,2690,1540,1150,10
403,32e91c0b-3b35-470e-8905-cb4307e9420a,43629255,2696,2692,4,11
403,32e91c0b-3b35-470e-8905-cb4307e9420a,43629255,2814,2701,113,23
404,7aa44cf2-93be-4715-9b50-cf1345664784,43875321,351,26,325,0
404,7aa44cf2-93be-4715-9b50-cf1345664784,43875321,1282,435,847,1
404,7aa44cf2-93be-4715-9b50-cf1345664784,43875321,2905,1314,1591,2
404,7aa44cf2-93be-4715-9b50-cf1345664784,43875321,3101,686,-2415,3
404,7aa44cf2-93be-4715-9b50-cf1345664784,43875321,613,413,-200,4
405,0fba288c-2301-438f-a883-73b8ee272c0c,43889678,553,28,525,0
405,0fba288c-2301-438f-a883-73b8ee272c0c,43889678,1001,490,511,1
405,0fba288c-2301-438f-a883-73b8ee272c0c,43889678,1019,1005,14,2
406,f0cb45f0-35c9-4a3c-9755-1003967b65ea,44014076,613,17,596,0
406,f0cb45f0-35c9-4a3c-9755-1003967b65ea,44014076,1919,697,1222,1
406,f0cb45f0-35c9-4a3c-9755-1003967b65ea,44014076,2005,0,-2005,2
406,f0cb45f0-35c9-4a3c-9755-1003967b65ea,44014076,28,24,4,3
406,f0cb45f0-35c9-4a3c-9755-1003967b65ea,44014076,34,27,7,5
406,f0cb45f0-35c9-4a3c-9755-1003967b65ea,44014076,102,35,67,6
406,f0cb45f0-35c9-4a3c-9755-1003967b65ea,44014076,176,113,63,10
406,f0cb45f0-35c9-4a3c-9755-1003967b65ea,44014076,299,179,120,11
406,f0cb45f0-35c9-4a3c-9755-1003967b65ea,44014076,396,301,95,12
406,f0cb45f0-35c9-4a3c-9755-1003967b65ea,44014076,447,396,51,13
406,f0cb45f0-35c9-4a3c-9755-1003967b65ea,44014076,529,448,81,14
406,f0cb45f0-35c9-4a3c-9755-1003967b65ea,44014076,793,530,263,15
406,f0cb45f0-35c9-4a3c-9755-1003967b65ea,44014076,1259,795,464,16
406,f0cb45f0-35c9-4a3c-9755-1003967b65ea,44014076,2033,1297,736,17
406,f0cb45f0-35c9-4a3c-9755-1003967b65ea,44014076,2062,2040,22,18
406,f0cb45f0-35c9-4a3c-9755-1003967b65ea,44014076,2477,2068,409,19
406,f0cb45f0-35c9-4a3c-9755-1003967b65ea,44014076,2629,2483,146,20
406,f0cb45f0-35c9-4a3c-9755-1003967b65ea,44014076,3003,2646,357,21
406,f0cb45f0-35c9-4a3c-9755-1003967b65ea,44014076,3726,3025,701,25
406,f0cb45f0-35c9-4a3c-9755-1003967b65ea,44014076,4167,3766,401,26
406,f0cb45f0-35c9-4a3c-9755-1003967b65ea,44014076,4175,4175,0,40
406,f0cb45f0-35c9-4a3c-9755-1003967b65ea,44014076,4224,4187,37,41
406,f0cb45f0-35c9-4a3c-9755-1003967b65ea,44014076,4220,4220,0,42
406,f0cb45f0-35c9-4a3c-9755-1003967b65ea,44014076,4296,4222,74,43
406,f0cb45f0-35c9-4a3c-9755-1003967b65ea,44014076,4365,4297,68,44
406,f0cb45f0-35c9-4a3c-9755-1003967b65ea,44014076,4392,4366,26,45
406,f0cb45f0-35c9-4a3c-9755-1003967b65ea,44014076,4417,4393,24,46
406,f0cb45f0-35c9-4a3c-9755-1003967b65ea,44014076,4429,4417,12,47
406,f0cb45f0-35c9-4a3c-9755-1003967b65ea,44014076,4430,4430,0,48
406,f0cb45f0-35c9-4a3c-9755-1003967b65ea,44014076,4434,4431,3,49
406,f0cb45f0-35c9-4a3c-9755-1003967b65ea,44014076,4435,4435,0,50
406,f0cb45f0-35c9-4a3c-9755-1003967b65ea,44014076,4436,4436,0,53
406,f0cb45f0-35c9-4a3c-9755-1003967b65ea,44014076,4458,4438,20,55
406,f0cb45f0-35c9-4a3c-9755-1003967b65ea,44014076,4514,4459,55,56
406,f0cb45f0-35c9-4a3c-9755-1003967b65ea,44014076,4529,4515,14,57
406,f0cb45f0-35c9-4a3c-9755-1003967b65ea,44014076,4531,4530,1,58
406,f0cb45f0-35c9-4a3c-9755-1003967b65ea,44014076,4533,4530,3,59
406,f0cb45f0-35c9-4a3c-9755-1003967b65ea,44014076,4537,4532,5,60
406,f0cb45f0-35c9-4a3c-9755-1003967b65ea,44014076,4543,4538,5,61
406,f0cb45f0-35c9-4a3c-9755-1003967b65ea,44014076,4664,4545,119,62
406,f0cb45f0-35c9-4a3c-9755-1003967b65ea,44014076,5015,4679,336,67
406,f0cb45f0-35c9-4a3c-9755-1003967b65ea,44014076,5081,5021,60,68
406,f0cb45f0-35c9-4a3c-9755-1003967b65ea,44014076,6574,5098,1476,69
406,f0cb45f0-35c9-4a3c-9755-1003967b65ea,44014076,7644,6587,1057,70
406,f0cb45f0-35c9-4a3c-9755-1003967b65ea,44014076,8031,7679,352,71
406,f0cb45f0-35c9-4a3c-9755-1003967b65ea,44014076,8102,8057,45,72
406,f0cb45f0-35c9-4a3c-9755-1003967b65ea,44014076,8875,8090,785,73
406,f0cb45f0-35c9-4a3c-9755-1003967b65ea,44014076,10740,8988,1752,74
406,f0cb45f0-35c9-4a3c-9755-1003967b65ea,44012046,533,1,532,0
406,f0cb45f0-35c9-4a3c-9755-1003967b65ea,44012046,534,534,0,1
406,f0cb45f0-35c9-4a3c-9755-1003967b65ea,44012046,725,535,190,16
406,f0cb45f0-35c9-4a3c-9755-1003967b65ea,44012046,1106,734,372,17
406,f0cb45f0-35c9-4a3c-9755-1003967b65ea,44012046,1365,1114,251,25
406,f0cb45f0-35c9-4a3c-9755-1003967b65ea,44012046,1426,1371,55,26
406,f0cb45f0-35c9-4a3c-9755-1003967b65ea,44012046,1523,1433,90,51
406,f0cb45f0-35c9-4a3c-9755-1003967b65ea,44012046,1707,1528,179,61
406,f0cb45f0-35c9-4a3c-9755-1003967b65ea,44012046,1844,1712,132,62
406,f0cb45f0-35c9-4a3c-9755-1003967b65ea,44012046,2123,1848,275,87
406,f0cb45f0-35c9-4a3c-9755-1003967b65ea,44012046,2199,2128,71,88
406,f0cb45f0-35c9-4a3c-9755-1003967b65ea,44012046,2282,2202,80,89
406,f0cb45f0-35c9-4a3c-9755-1003967b65ea,44012046,2550,2298,252,106
406,f0cb45f0-35c9-4a3c-9755-1003967b65ea,44012046,2856,2554,302,107
406,f0cb45f0-35c9-4a3c-9755-1003967b65ea,44012046,2976,2857,119,123
406,f0cb45f0-35c9-4a3c-9755-1003967b65ea,44012046,3113,2981,132,124
406,f0cb45f0-35c9-4a3c-9755-1003967b65ea,44012046,3289,3124,165,144
406,f0cb45f0-35c9-4a3c-9755-1003967b65ea,44012046,3547,3308,239,154
406,f0cb45f0-35c9-4a3c-9755-1003967b65ea,44012046,3631,3554,77,155
406,f0cb45f0-35c9-4a3c-9755-1003967b65ea,44012046,3630,3630,0,156
406,f0cb45f0-35c9-4a3c-9755-1003967b65ea,44012046,3797,3641,156,164
406,f0cb45f0-35c9-4a3c-9755-1003967b65ea,44012046,3798,3798,0,165
406,f0cb45f0-35c9-4a3c-9755-1003967b65ea,44012046,3992,3843,149,171
406,f0cb45f0-35c9-4a3c-9755-1003967b65ea,44012046,4272,3990,282,172
406,f0cb45f0-35c9-4a3c-9755-1003967b65ea,44012046,4151,4147,4,173
406,f0cb45f0-35c9-4a3c-9755-1003967b65ea,44012046,4150,3918,-232,174
406,f0cb45f0-35c9-4a3c-9755-1003967b65ea,44012046,3914,3875,-39,175
406,f0cb45f0-35c9-4a3c-9755-1003967b65ea,44012046,3974,3892,82,193
406,f0cb45f0-35c9-4a3c-9755-1003967b65ea,44012046,4302,3987,315,194
406,f0cb45f0-35c9-4a3c-9755-1003967b65ea,44012046,4317,4303,14,195
406,f0cb45f0-35c9-4a3c-9755-1003967b65ea,44012046,4454,4342,112,205
406,f0cb45f0-35c9-4a3c-9755-1003967b65ea,44012046,4460,4455,5,206
406,f0cb45f0-35c9-4a3c-9755-1003967b65ea,44012046,4466,4461,5,207
406,f0cb45f0-35c9-4a3c-9755-1003967b65ea,44012046,4501,4467,34,208
406,f0cb45f0-35c9-4a3c-9755-1003967b65ea,44012046,4507,4499,8,209
406,f0cb45f0-35c9-4a3c-9755-1003967b65ea,44012046,4508,4315,-193,210
406,f0cb45f0-35c9-4a3c-9755-1003967b65ea,44012046,4312,3857,-455,211
406,f0cb45f0-35c9-4a3c-9755-1003967b65ea,44012046,3889,3831,58,212
406,f0cb45f0-35c9-4a3c-9755-1003967b65ea,44012046,3888,3757,-131,213
406,f0cb45f0-35c9-4a3c-9755-1003967b65ea,44012046,3756,3724,-32,214
406,f0cb45f0-35c9-4a3c-9755-1003967b65ea,44012046,3722,3469,-253,215
406,f0cb45f0-35c9-4a3c-9755-1003967b65ea,44012046,3466,3199,-267,216
406,f0cb45f0-35c9-4a3c-9755-1003967b65ea,44012046,3198,3172,-26,217
406,f0cb45f0-35c9-4a3c-9755-1003967b65ea,44012046,3171,3162,-9,218
406,f0cb45f0-35c9-4a3c-9755-1003967b65ea,44012046,3161,3094,-67,219
406,f0cb45f0-35c9-4a3c-9755-1003967b65ea,44012046,3087,3025,-62,220
406,f0cb45f0-35c9-4a3c-9755-1003967b65ea,44012046,3024,3021,-3,221
406,f0cb45f0-35c9-4a3c-9755-1003967b65ea,44012046,3020,3019,-1,222
406,f0cb45f0-35c9-4a3c-9755-1003967b65ea,44012046,3018,3018,0,223
406,f0cb45f0-35c9-4a3c-9755-1003967b65ea,44012046,3025,3019,6,224
406,f0cb45f0-35c9-4a3c-9755-1003967b65ea,44012046,3046,3027,19,225
406,f0cb45f0-35c9-4a3c-9755-1003967b65ea,44012046,3141,3047,94,226
406,f0cb45f0-35c9-4a3c-9755-1003967b65ea,44012046,3218,3145,73,227
406,f0cb45f0-35c9-4a3c-9755-1003967b65ea,44012046,3261,3219,42,228
406,f0cb45f0-35c9-4a3c-9755-1003967b65ea,44012046,3275,3262,13,234
406,f0cb45f0-35c9-4a3c-9755-1003967b65ea,44012046,3356,3276,80,235
406,f0cb45f0-35c9-4a3c-9755-1003967b65ea,44012046,3399,3357,42,236
406,f0cb45f0-35c9-4a3c-9755-1003967b65ea,44012046,3409,3400,9,237
406,f0cb45f0-35c9-4a3c-9755-1003967b65ea,44012046,3422,3410,12,238
406,f0cb45f0-35c9-4a3c-9755-1003967b65ea,44012046,3441,3423,18,239
406,f0cb45f0-35c9-4a3c-9755-1003967b65ea,44012046,3595,3442,153,240
406,f0cb45f0-35c9-4a3c-9755-1003967b65ea,44012046,3618,3596,22,241
406,f0cb45f0-35c9-4a3c-9755-1003967b65ea,44012046,3622,3622,0,242
406,f0cb45f0-35c9-4a3c-9755-1003967b65ea,44012046,3688,3628,60,243
406,f0cb45f0-35c9-4a3c-9755-1003967b65ea,44012046,3697,3690,7,244
406,f0cb45f0-35c9-4a3c-9755-1003967b65ea,44012046,3718,3698,20,245
406,f0cb45f0-35c9-4a3c-9755-1003967b65ea,44012046,3748,3720,28,246
406,f0cb45f0-35c9-4a3c-9755-1003967b65ea,44012046,3763,3749,14,247
406,f0cb45f0-35c9-4a3c-9755-1003967b65ea,44012046,3802,3764,38,248
406,f0cb45f0-35c9-4a3c-9755-1003967b65ea,44012046,3816,3804,12,249
406,f0cb45f0-35c9-4a3c-9755-1003967b65ea,44012046,3838,3817,21,250
406,f0cb45f0-35c9-4a3c-9755-1003967b65ea,44012046,3875,3840,35,251
406,f0cb45f0-35c9-4a3c-9755-1003967b65ea,44012046,3955,3876,79,252
406,f0cb45f0-35c9-4a3c-9755-1003967b65ea,44012046,4000,3959,41,253
406,f0cb45f0-35c9-4a3c-9755-1003967b65ea,44012046,4116,4003,113,258
406,f0cb45f0-35c9-4a3c-9755-1003967b65ea,44012046,4146,4118,28,259
406,f0cb45f0-35c9-4a3c-9755-1003967b65ea,44012046,4145,4145,0,260
406,f0cb45f0-35c9-4a3c-9755-1003967b65ea,44012046,4205,4146,59,261
406,f0cb45f0-35c9-4a3c-9755-1003967b65ea,44012046,4229,4207,22,262
406,f0cb45f0-35c9-4a3c-9755-1003967b65ea,44012046,4307,4232,75,268
406,f0cb45f0-35c9-4a3c-9755-1003967b65ea,44012046,4324,4308,16,269
406,f0cb45f0-35c9-4a3c-9755-1003967b65ea,44012046,4341,4325,16,270
406,f0cb45f0-35c9-4a3c-9755-1003967b65ea,44012046,4406,4343,63,271
406,f0cb45f0-35c9-4a3c-9755-1003967b65ea,44012046,4442,4407,35,272
406,f0cb45f0-35c9-4a3c-9755-1003967b65ea,44012046,4495,4443,52,273
406,f0cb45f0-35c9-4a3c-9755-1003967b65ea,44012046,4597,4494,103,274
406,f0cb45f0-35c9-4a3c-9755-1003967b65ea,44012046,4639,4599,40,275
406,f0cb45f0-35c9-4a3c-9755-1003967b65ea,44012046,4658,4641,17,276
406,f0cb45f0-35c9-4a3c-9755-1003967b65ea,44012046,4676,4659,17,277
406,f0cb45f0-35c9-4a3c-9755-1003967b65ea,44012046,4683,4677,6,278
406,f0cb45f0-35c9-4a3c-9755-1003967b65ea,44012046,4833,4684,149,279
406,f0cb45f0-35c9-4a3c-9755-1003967b65ea,44012046,4883,4835,48,280
406,f0cb45f0-35c9-4a3c-9755-1003967b65ea,44012046,5154,4887,267,281
406,f0cb45f0-35c9-4a3c-9755-1003967b65ea,44012046,5182,5155,27,282
406,f0cb45f0-35c9-4a3c-9755-1003967b65ea,44012046,5181,5172,-9,283
406,f0cb45f0-35c9-4a3c-9755-1003967b65ea,44012046,5171,5037,-134,284
406,f0cb45f0-35c9-4a3c-9755-1003967b65ea,44012046,5031,4757,-274,285
406,f0cb45f0-35c9-4a3c-9755-1003967b65ea,44012046,4926,4759,167,286
406,f0cb45f0-35c9-4a3c-9755-1003967b65ea,44012046,4989,4690,-299,287
406,f0cb45f0-35c9-4a3c-9755-1003967b65ea,44012046,4689,4660,-29,288
406,f0cb45f0-35c9-4a3c-9755-1003967b65ea,44012046,4760,4684,76,289
406,f0cb45f0-35c9-4a3c-9755-1003967b65ea,44012046,4831,4763,68,290
406,f0cb45f0-35c9-4a3c-9755-1003967b65ea,44012046,4847,4838,9,291
406,f0cb45f0-35c9-4a3c-9755-1003967b65ea,44012046,4885,4853,32,292
406,f0cb45f0-35c9-4a3c-9755-1003967b65ea,44012046,4904,4886,18,293
406,f0cb45f0-35c9-4a3c-9755-1003967b65ea,44012046,4924,4905,19,294
406,f0cb45f0-35c9-4a3c-9755-1003967b65ea,44012046,4941,4925,16,295
406,f0cb45f0-35c9-4a3c-9755-1003967b65ea,44012046,5406,4942,464,296
406,f0cb45f0-35c9-4a3c-9755-1003967b65ea,44012046,7064,5411,1653,297
406,f0cb45f0-35c9-4a3c-9755-1003967b65ea,44012046,7328,7068,260,298
406,f0cb45f0-35c9-4a3c-9755-1003967b65ea,44012046,7523,7330,193,299
406,f0cb45f0-35c9-4a3c-9755-1003967b65ea,44012046,7783,7527,256,300
406,f0cb45f0-35c9-4a3c-9755-1003967b65ea,44012046,7703,7402,-301,304
406,f0cb45f0-35c9-4a3c-9755-1003967b65ea,44012046,7399,6842,-557,305
406,f0cb45f0-35c9-4a3c-9755-1003967b65ea,44012046,6800,5906,-894,306
406,f0cb45f0-35c9-4a3c-9755-1003967b65ea,44012046,5939,5905,34,307
406,f0cb45f0-35c9-4a3c-9755-1003967b65ea,44012046,6004,5943,61,308
406,f0cb45f0-35c9-4a3c-9755-1003967b65ea,44012046,6072,5997,75,309
406,f0cb45f0-35c9-4a3c-9755-1003967b65ea,44012046,6115,6073,42,310
406,f0cb45f0-35c9-4a3c-9755-1003967b65ea,44012046,6126,6115,11,311
406,f0cb45f0-35c9-4a3c-9755-1003967b65ea,44012046,6139,6128,11,312
406,f0cb45f0-35c9-4a3c-9755-1003967b65ea,44012046,6201,6140,61,313
406,f0cb45f0-35c9-4a3c-9755-1003967b65ea,44012046,6260,6204,56,314
406,f0cb45f0-35c9-4a3c-9755-1003967b65ea,44012046,6357,6261,96,315
406,f0cb45f0-35c9-4a3c-9755-1003967b65ea,44012046,6373,6358,15,316
406,f0cb45f0-35c9-4a3c-9755-1003967b65ea,44012046,6398,6374,24,317
406,f0cb45f0-35c9-4a3c-9755-1003967b65ea,44012046,6464,6399,65,318
406,f0cb45f0-35c9-4a3c-9755-1003967b65ea,44012046,6480,6465,15,319
406,f0cb45f0-35c9-4a3c-9755-1003967b65ea,44012046,6562,6482,80,320
406,f0cb45f0-35c9-4a3c-9755-1003967b65ea,44012046,6568,6568,0,321
406,f0cb45f0-35c9-4a3c-9755-1003967b65ea,44012046,6647,6572,75,322
406,f0cb45f0-35c9-4a3c-9755-1003967b65ea,44012046,6729,6649,80,323
406,f0cb45f0-35c9-4a3c-9755-1003967b65ea,44012046,6746,6730,16,324
406,f0cb45f0-35c9-4a3c-9755-1003967b65ea,44012046,6759,6747,12,325
406,f0cb45f0-35c9-4a3c-9755-1003967b65ea,44012046,6810,6760,50,326
406,f0cb45f0-35c9-4a3c-9755-1003967b65ea,44012046,6834,6811,23,327
406,f0cb45f0-35c9-4a3c-9755-1003967b65ea,44012046,6859,6835,24,328
406,f0cb45f0-35c9-4a3c-9755-1003967b65ea,44012046,6893,6860,33,329
406,f0cb45f0-35c9-4a3c-9755-1003967b65ea,44012046,6919,6895,24,330
406,f0cb45f0-35c9-4a3c-9755-1003967b65ea,44012046,6953,6920,33,331
406,f0cb45f0-35c9-4a3c-9755-1003967b65ea,44012046,6991,6954,37,332
406,f0cb45f0-35c9-4a3c-9755-1003967b65ea,44012046,7016,6988,28,333
406,f0cb45f0-35c9-4a3c-9755-1003967b65ea,44012046,7044,7017,27,334
406,f0cb45f0-35c9-4a3c-9755-1003967b65ea,44012046,7099,7045,54,335
406,f0cb45f0-35c9-4a3c-9755-1003967b65ea,44012046,7154,7100,54,336
406,f0cb45f0-35c9-4a3c-9755-1003967b65ea,44012046,7224,7160,64,338
406,f0cb45f0-35c9-4a3c-9755-1003967b65ea,44012046,7232,7225,7,339
406,f0cb45f0-35c9-4a3c-9755-1003967b65ea,44012046,7253,7234,19,340
406,f0cb45f0-35c9-4a3c-9755-1003967b65ea,44012046,7269,7254,15,341
406,f0cb45f0-35c9-4a3c-9755-1003967b65ea,44012046,7285,7270,15,342
406,f0cb45f0-35c9-4a3c-9755-1003967b65ea,44012046,7307,7287,20,343
406,f0cb45f0-35c9-4a3c-9755-1003967b65ea,44012046,7333,7308,25,344
406,f0cb45f0-35c9-4a3c-9755-1003967b65ea,44012046,7362,7334,28,345
406,f0cb45f0-35c9-4a3c-9755-1003967b65ea,44012046,7377,7363,14,346
406,f0cb45f0-35c9-4a3c-9755-1003967b65ea,44012046,7386,7378,8,347
406,f0cb45f0-35c9-4a3c-9755-1003967b65ea,44012046,7408,7387,21,348
406,f0cb45f0-35c9-4a3c-9755-1003967b65ea,44012046,7462,7409,53,349
406,f0cb45f0-35c9-4a3c-9755-1003967b65ea,44012046,7503,7463,40,350
406,f0cb45f0-35c9-4a3c-9755-1003967b65ea,44012046,7522,7504,18,351
406,f0cb45f0-35c9-4a3c-9755-1003967b65ea,44012046,7526,7523,3,352
406,f0cb45f0-35c9-4a3c-9755-1003967b65ea,44012046,7525,7525,0,354
406,f0cb45f0-35c9-4a3c-9755-1003967b65ea,44012046,7539,7527,12,355
406,f0cb45f0-35c9-4a3c-9755-1003967b65ea,44012046,7559,7541,18,356
406,f0cb45f0-35c9-4a3c-9755-1003967b65ea,44012046,7563,7560,3,357
406,f0cb45f0-35c9-4a3c-9755-1003967b65ea,44012046,7573,7564,9,358
406,f0cb45f0-35c9-4a3c-9755-1003967b65ea,44012046,7658,7574,84,359
406,f0cb45f0-35c9-4a3c-9755-1003967b65ea,44012046,7708,7659,49,360
406,f0cb45f0-35c9-4a3c-9755-1003967b65ea,44012046,7718,7709,9,361
406,f0cb45f0-35c9-4a3c-9755-1003967b65ea,44012046,7747,7719,28,362
406,f0cb45f0-35c9-4a3c-9755-1003967b65ea,44012046,7770,7748,22,363
406,f0cb45f0-35c9-4a3c-9755-1003967b65ea,44012046,8097,7790,307,370
406,f0cb45f0-35c9-4a3c-9755-1003967b65ea,44012046,8628,8098,530,371
406,f0cb45f0-35c9-4a3c-9755-1003967b65ea,44012046,9757,8629,1128,372
406,f0cb45f0-35c9-4a3c-9755-1003967b65ea,44012046,9929,9764,165,373
406,f0cb45f0-35c9-4a3c-9755-1003967b65ea,44012046,10053,9928,125,374
406,f0cb45f0-35c9-4a3c-9755-1003967b65ea,44012046,10023,9830,-193,380
406,f0cb45f0-35c9-4a3c-9755-1003967b65ea,44012046,10053,9917,136,381
406,f0cb45f0-35c9-4a3c-9755-1003967b65ea,44012046,0,0,0,384
406,f0cb45f0-35c9-4a3c-9755-1003967b65ea,44012046,237,9,228,390
406,f0cb45f0-35c9-4a3c-9755-1003967b65ea,44012046,963,240,723,391
406,f0cb45f0-35c9-4a3c-9755-1003967b65ea,44012046,2799,964,1835,393
406,f0cb45f0-35c9-4a3c-9755-1003967b65ea,44012046,5066,2818,2248,394
406,f0cb45f0-35c9-4a3c-9755-1003967b65ea,44012046,5127,5077,50,395
407,b882783c-1dc3-4b16-96d9-516bb4b305ae,44011112,95,28,67,0
407,b882783c-1dc3-4b16-96d9-516bb4b305ae,44011112,329,96,233,1
407,b882783c-1dc3-4b16-96d9-516bb4b305ae,44011112,441,337,104,2
407,b882783c-1dc3-4b16-96d9-516bb4b305ae,44011112,528,445,83,3
407,b882783c-1dc3-4b16-96d9-516bb4b305ae,44011112,659,538,121,4
407,b882783c-1dc3-4b16-96d9-516bb4b305ae,44011112,1617,674,943,5
407,b882783c-1dc3-4b16-96d9-516bb4b305ae,44011112,1766,1645,121,6
407,b882783c-1dc3-4b16-96d9-516bb4b305ae,44011112,2384,1771,613,7
407,b882783c-1dc3-4b16-96d9-516bb4b305ae,44011112,2442,2392,50,8
407,b882783c-1dc3-4b16-96d9-516bb4b305ae,44011112,2475,2446,29,9
407,b882783c-1dc3-4b16-96d9-516bb4b305ae,44011112,2449,0,-2449,10
406,73464d69-81ef-493e-9819-d8e5efa9710d,43981895,138,42,96,0
406,73464d69-81ef-493e-9819-d8e5efa9710d,43981895,190,0,-190,1
406,73464d69-81ef-493e-9819-d8e5efa9710d,43981895,186,1,185,2
406,73464d69-81ef-493e-9819-d8e5efa9710d,43981895,336,190,146,3
406,73464d69-81ef-493e-9819-d8e5efa9710d,43981895,493,334,159,4
406,73464d69-81ef-493e-9819-d8e5efa9710d,43981895,771,498,273,5
406,73464d69-81ef-493e-9819-d8e5efa9710d,43981895,932,780,152,6
406,73464d69-81ef-493e-9819-d8e5efa9710d,43981895,1218,961,257,8
406,73464d69-81ef-493e-9819-d8e5efa9710d,43981895,1228,1221,7,9
406,73464d69-81ef-493e-9819-d8e5efa9710d,43981895,1275,1222,53,10
406,73464d69-81ef-493e-9819-d8e5efa9710d,43981895,1322,1224,-98,11
406,73464d69-81ef-493e-9819-d8e5efa9710d,43981895,1223,1206,-17,12
406,73464d69-81ef-493e-9819-d8e5efa9710d,43981895,1218,1205,13,13
406,73464d69-81ef-493e-9819-d8e5efa9710d,43981895,1439,1233,206,34
406,73464d69-81ef-493e-9819-d8e5efa9710d,43981895,1767,1458,309,35
406,73464d69-81ef-493e-9819-d8e5efa9710d,43981895,1836,1778,58,51
406,73464d69-81ef-493e-9819-d8e5efa9710d,43981895,2027,1844,183,52
406,73464d69-81ef-493e-9819-d8e5efa9710d,43981895,2181,2032,149,53
406,73464d69-81ef-493e-9819-d8e5efa9710d,43981895,2296,2180,116,59
406,73464d69-81ef-493e-9819-d8e5efa9710d,43981895,2751,2302,449,60
406,73464d69-81ef-493e-9819-d8e5efa9710d,43981895,3009,2784,225,61
406,73464d69-81ef-493e-9819-d8e5efa9710d,43981895,3326,3040,286,84
406,73464d69-81ef-493e-9819-d8e5efa9710d,43981895,4053,3336,717,85
406,73464d69-81ef-493e-9819-d8e5efa9710d,43981895,4377,4077,300,99
406,73464d69-81ef-493e-9819-d8e5efa9710d,43981895,4381,4375,-6,100
406,73464d69-81ef-493e-9819-d8e5efa9710d,43981895,4573,4426,147,116
406,73464d69-81ef-493e-9819-d8e5efa9710d,43981895,4900,4576,324,117
406,73464d69-81ef-493e-9819-d8e5efa9710d,43981895,5026,4902,124,119
406,73464d69-81ef-493e-9819-d8e5efa9710d,43981895,5321,5031,290,120
406,73464d69-81ef-493e-9819-d8e5efa9710d,43981895,5351,5323,28,121
406,73464d69-81ef-493e-9819-d8e5efa9710d,43981895,5449,5360,89,123
406,73464d69-81ef-493e-9819-d8e5efa9710d,43981895,5548,5453,95,124
406,73464d69-81ef-493e-9819-d8e5efa9710d,43981895,6516,5550,966,125
406,73464d69-81ef-493e-9819-d8e5efa9710d,43981895,6801,6360,-441,126
406,73464d69-81ef-493e-9819-d8e5efa9710d,43981895,6307,5284,-1023,127
406,73464d69-81ef-493e-9819-d8e5efa9710d,43981895,5464,5295,169,153
406,73464d69-81ef-493e-9819-d8e5efa9710d,43981895,5579,5431,148,162
406,73464d69-81ef-493e-9819-d8e5efa9710d,43981895,6011,5601,410,163
406,73464d69-81ef-493e-9819-d8e5efa9710d,43981895,6747,6019,728,172
406,73464d69-81ef-493e-9819-d8e5efa9710d,43981895,7158,6646,-512,173
406,73464d69-81ef-493e-9819-d8e5efa9710d,43981895,7080,6671,409,177
406,f3ccff50-fc58-4430-804b-b928b8dba3f9,44010298,70,10,60,0
406,f3ccff50-fc58-4430-804b-b928b8dba3f9,44010298,65,64,-1,1
406,f3ccff50-fc58-4430-804b-b928b8dba3f9,44010298,63,60,-3,2
406,f3ccff50-fc58-4430-804b-b928b8dba3f9,44010298,130,51,79,3
406,f3ccff50-fc58-4430-804b-b928b8dba3f9,44010298,581,133,448,4
406,f3ccff50-fc58-4430-804b-b928b8dba3f9,44010298,1107,618,489,5
406,f3ccff50-fc58-4430-804b-b928b8dba3f9,44010298,1411,1113,298,17
406,f3ccff50-fc58-4430-804b-b928b8dba3f9,44010298,1466,1415,51,18
406,f3ccff50-fc58-4430-804b-b928b8dba3f9,44010298,1669,1469,200,30
406,f3ccff50-fc58-4430-804b-b928b8dba3f9,44010298,1854,1697,157,31
406,f3ccff50-fc58-4430-804b-b928b8dba3f9,44010298,1866,1840,26,55
406,f3ccff50-fc58-4430-804b-b928b8dba3f9,44010298,1877,1868,9,56
406,f3ccff50-fc58-4430-804b-b928b8dba3f9,44010298,2730,1905,825,77
406,f3ccff50-fc58-4430-804b-b928b8dba3f9,44010298,3888,2745,1143,78
406,f3ccff50-fc58-4430-804b-b928b8dba3f9,44010298,3886,3063,-823,79
406,f3ccff50-fc58-4430-804b-b928b8dba3f9,44010298,3118,3071,47,106
406,f3ccff50-fc58-4430-804b-b928b8dba3f9,44010298,3344,3129,215,107
407,d62e979f-9b86-4f5f-9853-7dca35ad500c,43995168,202,1,201,0
407,d62e979f-9b86-4f5f-9853-7dca35ad500c,43995168,347,213,134,1
407,d62e979f-9b86-4f5f-9853-7dca35ad500c,43995168,465,353,112,2
407,d62e979f-9b86-4f5f-9853-7dca35ad500c,43995168,1177,467,710,3
407,d62e979f-9b86-4f5f-9853-7dca35ad500c,43995168,1250,1182,68,4
407,d62e979f-9b86-4f5f-9853-7dca35ad500c,43995168,1346,1256,90,5
407,d62e979f-9b86-4f5f-9853-7dca35ad500c,43995168,1578,1355,223,6
407,d62e979f-9b86-4f5f-9853-7dca35ad500c,43995168,1981,1580,401,7
407,d62e979f-9b86-4f5f-9853-7dca35ad500c,43995168,2418,1990,428,8
407,d62e979f-9b86-4f5f-9853-7dca35ad500c,43995168,2515,2419,96,9
407,d62e979f-9b86-4f5f-9853-7dca35ad500c,43995168,2669,2521,148,10
407,d62e979f-9b86-4f5f-9853-7dca35ad500c,43995168,2760,2671,89,12
407,d62e979f-9b86-4f5f-9853-7dca35ad500c,43995168,2839,2765,74,13
407,d62e979f-9b86-4f5f-9853-7dca35ad500c,43995168,3028,2848,180,15
407,d62e979f-9b86-4f5f-9853-7dca35ad500c,43995168,3181,3032,149,16
407,d62e979f-9b86-4f5f-9853-7dca35ad500c,43995168,3618,3187,431,17
407,d62e979f-9b86-4f5f-9853-7dca35ad500c,43995168,4595,3627,968,18
407,d62e979f-9b86-4f5f-9853-7dca35ad500c,43995168,5592,4660,932,19
407,991f2c93-8a98-4a88-b9eb-084e9e2f016f,44017054,304,22,282,0
407,991f2c93-8a98-4a88-b9eb-084e9e2f016f,44017054,415,312,103,5
407,991f2c93-8a98-4a88-b9eb-084e9e2f016f,44017054,654,417,237,6
407,991f2c93-8a98-4a88-b9eb-084e9e2f016f,44017054,733,661,72,7
407,991f2c93-8a98-4a88-b9eb-084e9e2f016f,44017054,794,737,57,8
407,991f2c93-8a98-4a88-b9eb-084e9e2f016f,44017054,1511,806,705,9
407,991f2c93-8a98-4a88-b9eb-084e9e2f016f,44017054,1934,1535,399,10
407,991f2c93-8a98-4a88-b9eb-084e9e2f016f,44017054,2120,1944,176,11
407,991f2c93-8a98-4a88-b9eb-084e9e2f016f,44017054,2525,2124,401,12
407,991f2c93-8a98-4a88-b9eb-084e9e2f016f,44017054,3029,2562,467,13
407,991f2c93-8a98-4a88-b9eb-084e9e2f016f,44017054,3202,3037,165,14
406,d8facddc-edb4-4612-97ff-5a069db847c1,44011112,1423,51,1372,0
406,d8facddc-edb4-4612-97ff-5a069db847c1,44011112,1684,1448,236,1
406,d8facddc-edb4-4612-97ff-5a069db847c1,44011112,4406,1686,2720,7
406,d8facddc-edb4-4612-97ff-5a069db847c1,44011112,4485,4426,59,8
406,d8facddc-edb4-4612-97ff-5a069db847c1,44011112,4483,3270,-1213,18
406,d8facddc-edb4-4612-97ff-5a069db847c1,44011112,3264,3240,-24,19
406,d8facddc-edb4-4612-97ff-5a069db847c1,44011112,3324,2848,-476,24
406,d8facddc-edb4-4612-97ff-5a069db847c1,44011112,2823,1111,-1712,25
406,d8facddc-edb4-4612-97ff-5a069db847c1,44011112,1096,209,-887,26
406,d8facddc-edb4-4612-97ff-5a069db847c1,44011112,788,567,221,27
406,d8facddc-edb4-4612-97ff-5a069db847c1,44015562,114,6,108,0
406,d8facddc-edb4-4612-97ff-5a069db847c1,44015562,311,125,186,3
406,d8facddc-edb4-4612-97ff-5a069db847c1,44015562,540,332,208,4
406,d8facddc-edb4-4612-97ff-5a069db847c1,44015562,711,553,158,5
406,d8facddc-edb4-4612-97ff-5a069db847c1,44015562,818,721,97,6
406,d8facddc-edb4-4612-97ff-5a069db847c1,44015562,905,788,117,7
406,d8facddc-edb4-4612-97ff-5a069db847c1,44015562,1058,919,139,16
406,d8facddc-edb4-4612-97ff-5a069db847c1,44015562,1242,1066,176,17
406,d8facddc-edb4-4612-97ff-5a069db847c1,44015562,1801,1252,549,18
406,d8facddc-edb4-4612-97ff-5a069db847c1,44015562,2012,1809,203,19
406,d8facddc-edb4-4612-97ff-5a069db847c1,44015562,2200,2014,186,20
406,d8facddc-edb4-4612-97ff-5a069db847c1,44015562,2406,2201,205,21
406,d8facddc-edb4-4612-97ff-5a069db847c1,44015562,2627,2412,215,22
406,d8facddc-edb4-4612-97ff-5a069db847c1,44015562,3003,2650,353,23
406,d8facddc-edb4-4612-97ff-5a069db847c1,44015562,3001,2979,-22,25
406,d8facddc-edb4-4612-97ff-5a069db847c1,44015562,3003,2994,9,26
406,d8facddc-edb4-4612-97ff-5a069db847c1,44015562,3000,2977,-23,27
406,d8facddc-edb4-4612-97ff-5a069db847c1,44015562,3003,2986,17,29
406,d8facddc-edb4-4612-97ff-5a069db847c1,44015562,3003,3000,3,30
406,d8facddc-edb4-4612-97ff-5a069db847c1,44008098,434,1,433,0
406,d8facddc-edb4-4612-97ff-5a069db847c1,44008098,672,450,222,2
406,d8facddc-edb4-4612-97ff-5a069db847c1,44008098,673,673,0,3
406,d8facddc-edb4-4612-97ff-5a069db847c1,44008098,871,677,194,4
406,d8facddc-edb4-4612-97ff-5a069db847c1,44008098,1284,901,383,9
406,d8facddc-edb4-4612-97ff-5a069db847c1,44008098,1390,1300,90,10
406,d8facddc-edb4-4612-97ff-5a069db847c1,44008098,1897,1426,471,47
406,d8facddc-edb4-4612-97ff-5a069db847c1,44008098,2922,1899,1023,48
406,d8facddc-edb4-4612-97ff-5a069db847c1,44008098,3310,2925,385,49
406,d8facddc-edb4-4612-97ff-5a069db847c1,44008098,3607,3324,283,50
406,d8facddc-edb4-4612-97ff-5a069db847c1,44008098,3872,3627,245,51
406,d8facddc-edb4-4612-97ff-5a069db847c1,44008098,5711,3875,1836,52
406,d8facddc-edb4-4612-97ff-5a069db847c1,44008098,6522,5743,779,53
407,83192099-03ff-42ec-9b8a-ed68a9b16bd6,44019175,150,12,138,0
407,83192099-03ff-42ec-9b8a-ed68a9b16bd6,44019175,322,158,164,1
407,83192099-03ff-42ec-9b8a-ed68a9b16bd6,44019175,656,329,327,2
407,83192099-03ff-42ec-9b8a-ed68a9b16bd6,44019175,763,663,100,3
407,83192099-03ff-42ec-9b8a-ed68a9b16bd6,44019175,913,765,148,4
407,83192099-03ff-42ec-9b8a-ed68a9b16bd6,44019175,1038,938,100,5
407,83192099-03ff-42ec-9b8a-ed68a9b16bd6,44019175,1150,1044,106,6
407,83192099-03ff-42ec-9b8a-ed68a9b16bd6,44019175,1240,1159,81,7
407,83192099-03ff-42ec-9b8a-ed68a9b16bd6,44019175,1345,1248,97,10
407,83192099-03ff-42ec-9b8a-ed68a9b16bd6,44019175,1529,1361,168,11
407,83192099-03ff-42ec-9b8a-ed68a9b16bd6,44019175,1821,1531,290,18
407,83192099-03ff-42ec-9b8a-ed68a9b16bd6,44019175,2097,1854,243,19
407,83192099-03ff-42ec-9b8a-ed68a9b16bd6,43980567,513,8,505,0
407,83192099-03ff-42ec-9b8a-ed68a9b16bd6,43980567,633,521,112,1
407,83192099-03ff-42ec-9b8a-ed68a9b16bd6,43980567,1265,668,597,2
407,83192099-03ff-42ec-9b8a-ed68a9b16bd6,43980567,2956,1271,1685,3
407,83192099-03ff-42ec-9b8a-ed68a9b16bd6,43980567,3542,3012,530,4
407,83192099-03ff-42ec-9b8a-ed68a9b16bd6,43980567,4042,3555,487,6
407,83192099-03ff-42ec-9b8a-ed68a9b16bd6,43980567,4687,4052,635,7
407,83192099-03ff-42ec-9b8a-ed68a9b16bd6,43980567,5071,4708,363,8
407,83192099-03ff-42ec-9b8a-ed68a9b16bd6,43980567,5166,5086,80,9
407,83192099-03ff-42ec-9b8a-ed68a9b16bd6,43980567,5091,3636,-1455,10
407,83192099-03ff-42ec-9b8a-ed68a9b16bd6,43980567,3603,347,-3256,11
407,83192099-03ff-42ec-9b8a-ed68a9b16bd6,43980567,279,0,-279,12
407,83192099-03ff-42ec-9b8a-ed68a9b16bd6,43980567,209,4,205,13
407,83192099-03ff-42ec-9b8a-ed68a9b16bd6,43980567,336,227,109,14
407,83192099-03ff-42ec-9b8a-ed68a9b16bd6,43980567,363,340,23,15
407,83192099-03ff-42ec-9b8a-ed68a9b16bd6,43980567,394,364,30,17
407,83192099-03ff-42ec-9b8a-ed68a9b16bd6,43980567,747,417,330,18
407,2f0bf9b1-c529-4153-bd49-20e9d46e33b1,44020235,219,12,207,0
407,2f0bf9b1-c529-4153-bd49-20e9d46e33b1,44020235,334,229,105,1
407,2f0bf9b1-c529-4153-bd49-20e9d46e33b1,44020235,379,337,42,2
407,2f0bf9b1-c529-4153-bd49-20e9d46e33b1,44020235,393,381,12,3
407,2f0bf9b1-c529-4153-bd49-20e9d46e33b1,44020235,541,406,135,4
407,2f0bf9b1-c529-4153-bd49-20e9d46e33b1,44020235,638,555,83,5
407,2f0bf9b1-c529-4153-bd49-20e9d46e33b1,44020235,803,643,160,6
407,2f0bf9b1-c529-4153-bd49-20e9d46e33b1,44020235,981,806,175,7
407,2f0bf9b1-c529-4153-bd49-20e9d46e33b1,44020235,1415,992,423,8
407,2f0bf9b1-c529-4153-bd49-20e9d46e33b1,44020235,2580,1426,1154,9
407,2f0bf9b1-c529-4153-bd49-20e9d46e33b1,44020235,2898,2609,289,10
407,2f0bf9b1-c529-4153-bd49-20e9d46e33b1,44020235,3001,2904,97,11
407,2f0bf9b1-c529-4153-bd49-20e9d46e33b1,44020235,4085,3037,1048,12
407,2f0bf9b1-c529-4153-bd49-20e9d46e33b1,44021829,96,2,94,0
407,2f0bf9b1-c529-4153-bd49-20e9d46e33b1,44021829,239,99,140,1
407,2f0bf9b1-c529-4153-bd49-20e9d46e33b1,44021829,325,247,78,2
407,2f0bf9b1-c529-4153-bd49-20e9d46e33b1,44021829,548,328,220,3
407,2f0bf9b1-c529-4153-bd49-20e9d46e33b1,44021829,629,554,75,4
407,2f0bf9b1-c529-4153-bd49-20e9d46e33b1,44021829,1071,633,438,5
407,2f0bf9b1-c529-4153-bd49-20e9d46e33b1,44021829,1097,1077,20,6
407,2f0bf9b1-c529-4153-bd49-20e9d46e33b1,44021829,1592,1101,491,8
407,2f0bf9b1-c529-4153-bd49-20e9d46e33b1,44021829,1730,1595,135,9
407,2f0bf9b1-c529-4153-bd49-20e9d46e33b1,44021829,1849,1733,116,10
407,2f0bf9b1-c529-4153-bd49-20e9d46e33b1,44021829,1953,1850,103,11
407,2f0bf9b1-c529-4153-bd49-20e9d46e33b1,44021829,2076,1962,114,12
407,2f0bf9b1-c529-4153-bd49-20e9d46e33b1,44021829,2281,2077,204,13
407,2f0bf9b1-c529-4153-bd49-20e9d46e33b1,44021829,2334,2283,51,14
407,2f0bf9b1-c529-4153-bd49-20e9d46e33b1,44021829,2492,2335,157,15
407,2f0bf9b1-c529-4153-bd49-20e9d46e33b1,44021829,2579,2509,70,16
407,2f0bf9b1-c529-4153-bd49-20e9d46e33b1,44021829,2611,2581,30,17
407,2f0bf9b1-c529-4153-bd49-20e9d46e33b1,44021829,3259,2650,609,18
407,2f0bf9b1-c529-4153-bd49-20e9d46e33b1,44021829,4374,3260,1114,19
407,2f0bf9b1-c529-4153-bd49-20e9d46e33b1,44021052,299,19,280,0
407,2f0bf9b1-c529-4153-bd49-20e9d46e33b1,44021052,341,307,34,1
407,2f0bf9b1-c529-4153-bd49-20e9d46e33b1,44021052,495,353,142,3
407,2f0bf9b1-c529-4153-bd49-20e9d46e33b1,44021052,600,499,101,4
407,2f0bf9b1-c529-4153-bd49-20e9d46e33b1,44021052,648,603,45,5
407,2f0bf9b1-c529-4153-bd49-20e9d46e33b1,44021052,705,660,45,6
407,2f0bf9b1-c529-4153-bd49-20e9d46e33b1,44021052,742,710,32,7
407,2f0bf9b1-c529-4153-bd49-20e9d46e33b1,44021052,737,640,-97,9
407,2f0bf9b1-c529-4153-bd49-20e9d46e33b1,44021052,638,597,-41,10
407,2f0bf9b1-c529-4153-bd49-20e9d46e33b1,44021052,647,600,47,12
407,2f0bf9b1-c529-4153-bd49-20e9d46e33b1,44021052,684,649,35,13
407,2f0bf9b1-c529-4153-bd49-20e9d46e33b1,44021052,857,692,165,14
407,2f0bf9b1-c529-4153-bd49-20e9d46e33b1,44021052,907,868,39,15
407,2f0bf9b1-c529-4153-bd49-20e9d46e33b1,44021052,1159,915,244,22
407,2f0bf9b1-c529-4153-bd49-20e9d46e33b1,44021052,1501,1160,341,23
407,2f0bf9b1-c529-4153-bd49-20e9d46e33b1,44021052,1679,1507,172,24
407,2f0bf9b1-c529-4153-bd49-20e9d46e33b1,44021052,1813,1695,118,25
407,2f0bf9b1-c529-4153-bd49-20e9d46e33b1,44021052,2342,1829,513,26
407,2f0bf9b1-c529-4153-bd49-20e9d46e33b1,44021052,3308,2348,960,27
407,2f0bf9b1-c529-4153-bd49-20e9d46e33b1,44021052,3383,3315,68,35
407,2f0bf9b1-c529-4153-bd49-20e9d46e33b1,44021052,3491,3386,105,36
407,2f0bf9b1-c529-4153-bd49-20e9d46e33b1,44021052,4044,3496,548,37
407,2f0bf9b1-c529-4153-bd49-20e9d46e33b1,44017046,78,10,68,0
407,2f0bf9b1-c529-4153-bd49-20e9d46e33b1,44017046,502,80,422,1
407,2f0bf9b1-c529-4153-bd49-20e9d46e33b1,44017046,1054,506,548,2
407,2f0bf9b1-c529-4153-bd49-20e9d46e33b1,44017046,1347,1065,282,3
407,2f0bf9b1-c529-4153-bd49-20e9d46e33b1,44017046,1329,1197,-132,6
407,2f0bf9b1-c529-4153-bd49-20e9d46e33b1,44017046,1189,1135,-54,7
407,2f0bf9b1-c529-4153-bd49-20e9d46e33b1,44017046,1308,1039,269,8
407,2f0bf9b1-c529-4153-bd49-20e9d46e33b1,44017046,1571,1337,234,9
407,2f0bf9b1-c529-4153-bd49-20e9d46e33b1,44017046,1622,1576,46,10
407,2f0bf9b1-c529-4153-bd49-20e9d46e33b1,44017046,1764,1628,136,11
407,2f0bf9b1-c529-4153-bd49-20e9d46e33b1,44017046,1945,1768,177,12
407,2f0bf9b1-c529-4153-bd49-20e9d46e33b1,44017046,2060,1948,112,13
407,2f0bf9b1-c529-4153-bd49-20e9d46e33b1,44017046,2228,2071,157,14
407,2f0bf9b1-c529-4153-bd49-20e9d46e33b1,44017046,2483,2229,254,15
407,2f0bf9b1-c529-4153-bd49-20e9d46e33b1,44017046,2678,2485,193,16
407,2f0bf9b1-c529-4153-bd49-20e9d46e33b1,44017046,2848,2689,159,17
407,2f0bf9b1-c529-4153-bd49-20e9d46e33b1,44017046,2976,2854,122,18
407,2f0bf9b1-c529-4153-bd49-20e9d46e33b1,44017046,3112,2989,123,19
407,2f0bf9b1-c529-4153-bd49-20e9d46e33b1,44017046,3381,3122,259,20
407,2f0bf9b1-c529-4153-bd49-20e9d46e33b1,44017046,3445,3393,52,21
407,2f0bf9b1-c529-4153-bd49-20e9d46e33b1,44017046,3571,3446,125,22
407,2f0bf9b1-c529-4153-bd49-20e9d46e33b1,44017046,3745,3584,161,23
407,2f0bf9b1-c529-4153-bd49-20e9d46e33b1,44017046,3814,3749,65,24
407,2f0bf9b1-c529-4153-bd49-20e9d46e33b1,44017046,3860,3818,42,26
407,2f0bf9b1-c529-4153-bd49-20e9d46e33b1,44017046,3871,3863,8,29
407,2f0bf9b1-c529-4153-bd49-20e9d46e33b1,44017046,3995,3875,120,30
407,2f0bf9b1-c529-4153-bd49-20e9d46e33b1,44017046,4175,4013,162,31
407,2f0bf9b1-c529-4153-bd49-20e9d46e33b1,44017046,4236,4185,51,32
407,2f0bf9b1-c529-4153-bd49-20e9d46e33b1,44017046,4316,4244,72,48
407,2f0bf9b1-c529-4153-bd49-20e9d46e33b1,44017046,4364,4331,33,49
407,2f0bf9b1-c529-4153-bd49-20e9d46e33b1,44017046,4312,3569,-743,52
407,2f0bf9b1-c529-4153-bd49-20e9d46e33b1,44017046,3472,2974,498,53
407,2f0bf9b1-c529-4153-bd49-20e9d46e33b1,44017046,3454,2967,-487,54
407,2f0bf9b1-c529-4153-bd49-20e9d46e33b1,44017588,198,10,188,0
407,2f0bf9b1-c529-4153-bd49-20e9d46e33b1,44017588,430,209,221,8
407,2f0bf9b1-c529-4153-bd49-20e9d46e33b1,44017588,766,443,323,13
407,2f0bf9b1-c529-4153-bd49-20e9d46e33b1,44017588,886,767,119,15
407,2f0bf9b1-c529-4153-bd49-20e9d46e33b1,44017588,896,890,6,16
407,2f0bf9b1-c529-4153-bd49-20e9d46e33b1,44017588,1053,905,148,22
407,2f0bf9b1-c529-4153-bd49-20e9d46e33b1,44017588,1236,1061,175,23
407,2f0bf9b1-c529-4153-bd49-20e9d46e33b1,44017588,1443,1244,199,24
407,2f0bf9b1-c529-4153-bd49-20e9d46e33b1,44017588,1449,1447,2,25
407,2f0bf9b1-c529-4153-bd49-20e9d46e33b1,44017588,1565,1455,110,26
407,2f0bf9b1-c529-4153-bd49-20e9d46e33b1,44017588,1651,1570,81,27
407,2f0bf9b1-c529-4153-bd49-20e9d46e33b1,44017588,1834,1667,167,28
407,2f0bf9b1-c529-4153-bd49-20e9d46e33b1,44017588,1914,1850,64,29
407,2f0bf9b1-c529-4153-bd49-20e9d46e33b1,44017588,1994,1929,65,30
407,2f0bf9b1-c529-4153-bd49-20e9d46e33b1,44017588,2060,2006,54,35
407,2f0bf9b1-c529-4153-bd49-20e9d46e33b1,44017588,2124,2068,56,36
407,2f0bf9b1-c529-4153-bd49-20e9d46e33b1,44017588,2125,2125,0,37
407,2f0bf9b1-c529-4153-bd49-20e9d46e33b1,44017588,2346,2142,204,42
407,2f0bf9b1-c529-4153-bd49-20e9d46e33b1,44017588,2342,2197,-145,51
407,2f0bf9b1-c529-4153-bd49-20e9d46e33b1,44017588,2157,0,-2157,52
406,70e7a7d2-6e10-44de-8162-bc8611d65ee6,44020061,1128,9,1119,0
406,70e7a7d2-6e10-44de-8162-bc8611d65ee6,44020061,1148,1133,15,1
406,70e7a7d2-6e10-44de-8162-bc8611d65ee6,44020061,1129,956,-173,2
406,70e7a7d2-6e10-44de-8162-bc8611d65ee6,44020061,957,954,3,3
406,70e7a7d2-6e10-44de-8162-bc8611d65ee6,44020061,990,958,32,4
406,70e7a7d2-6e10-44de-8162-bc8611d65ee6,44020061,1813,993,820,5
406,70e7a7d2-6e10-44de-8162-bc8611d65ee6,44020061,1939,1829,110,6
406,70e7a7d2-6e10-44de-8162-bc8611d65ee6,44020061,2087,1959,128,10
406,70e7a7d2-6e10-44de-8162-bc8611d65ee6,44020061,2154,2087,67,11
406,70e7a7d2-6e10-44de-8162-bc8611d65ee6,44020061,2163,2155,8,12
406,70e7a7d2-6e10-44de-8162-bc8611d65ee6,44020061,2198,2164,34,13
406,70e7a7d2-6e10-44de-8162-bc8611d65ee6,44020061,2223,2198,25,14
406,70e7a7d2-6e10-44de-8162-bc8611d65ee6,44020061,2225,2224,1,15
406,70e7a7d2-6e10-44de-8162-bc8611d65ee6,44020061,2226,2226,0,19
406,70e7a7d2-6e10-44de-8162-bc8611d65ee6,44020061,2877,2227,650,22
406,70e7a7d2-6e10-44de-8162-bc8611d65ee6,44020061,3477,2879,598,32
406,70e7a7d2-6e10-44de-8162-bc8611d65ee6,44020061,3507,3482,25,33
406,70e7a7d2-6e10-44de-8162-bc8611d65ee6,44017266,391,27,364,0
406,70e7a7d2-6e10-44de-8162-bc8611d65ee6,44017266,483,395,88,1
406,70e7a7d2-6e10-44de-8162-bc8611d65ee6,44017266,534,498,36,2
406,70e7a7d2-6e10-44de-8162-bc8611d65ee6,44017266,837,550,287,3
406,70e7a7d2-6e10-44de-8162-bc8611d65ee6,44017266,949,839,110,9
406,70e7a7d2-6e10-44de-8162-bc8611d65ee6,44017266,1211,969,242,10
406,70e7a7d2-6e10-44de-8162-bc8611d65ee6,44017266,1549,1217,332,11
406,70e7a7d2-6e10-44de-8162-bc8611d65ee6,44017266,1651,1557,94,19
406,70e7a7d2-6e10-44de-8162-bc8611d65ee6,44017266,1670,1657,13,20
406,70e7a7d2-6e10-44de-8162-bc8611d65ee6,44017266,1895,1677,218,25
406,70e7a7d2-6e10-44de-8162-bc8611d65ee6,44017266,1996,1901,95,26
406,70e7a7d2-6e10-44de-8162-bc8611d65ee6,44017266,2222,2005,217,27
406,70e7a7d2-6e10-44de-8162-bc8611d65ee6,44017266,2249,2224,25,32
406,70e7a7d2-6e10-44de-8162-bc8611d65ee6,44017266,2477,2252,225,33
406,70e7a7d2-6e10-44de-8162-bc8611d65ee6,44017266,2471,2371,-100,34
406,70e7a7d2-6e10-44de-8162-bc8611d65ee6,44017266,2365,2341,-24,35
406,70e7a7d2-6e10-44de-8162-bc8611d65ee6,44017266,2513,2346,167,39
406,70e7a7d2-6e10-44de-8162-bc8611d65ee6,44017266,2691,2520,171,40
406,70e7a7d2-6e10-44de-8162-bc8611d65ee6,44017266,2798,2695,103,45
406,70e7a7d2-6e10-44de-8162-bc8611d65ee6,44017266,3489,2804,685,46
406,70e7a7d2-6e10-44de-8162-bc8611d65ee6,44017266,4562,3490,1072,47
406,70e7a7d2-6e10-44de-8162-bc8611d65ee6,44017266,5260,4399,861,48
406,70e7a7d2-6e10-44de-8162-bc8611d65ee6,44017266,5247,4780,-467,49
406,70e7a7d2-6e10-44de-8162-bc8611d65ee6,44017266,4774,4446,-328,50
406,70e7a7d2-6e10-44de-8162-bc8611d65ee6,44017266,4441,4403,-38,51
406,70e7a7d2-6e10-44de-8162-bc8611d65ee6,44017266,4493,4416,77,71
406,70e7a7d2-6e10-44de-8162-bc8611d65ee6,44017266,4820,4501,319,72
406,70e7a7d2-6e10-44de-8162-bc8611d65ee6,44017266,4916,4827,89,76
406,70e7a7d2-6e10-44de-8162-bc8611d65ee6,44017266,5148,4917,231,77
406,70e7a7d2-6e10-44de-8162-bc8611d65ee6,44017266,5716,5150,566,78
406,70e7a7d2-6e10-44de-8162-bc8611d65ee6,44017266,5758,5723,35,79
406,70e7a7d2-6e10-44de-8162-bc8611d65ee6,44017266,5943,5759,184,80
406,70e7a7d2-6e10-44de-8162-bc8611d65ee6,44017266,6120,5966,154,81
406,70e7a7d2-6e10-44de-8162-bc8611d65ee6,44017266,6119,5810,-309,82
406,70e7a7d2-6e10-44de-8162-bc8611d65ee6,44017266,5812,5798,14,83
406,70e7a7d2-6e10-44de-8162-bc8611d65ee6,44017266,5915,5817,98,85
406,70e7a7d2-6e10-44de-8162-bc8611d65ee6,44017266,6110,5920,190,86
406,70e7a7d2-6e10-44de-8162-bc8611d65ee6,44017266,6580,6113,467,98
406,70e7a7d2-6e10-44de-8162-bc8611d65ee6,44017266,6796,6584,212,107
406,70e7a7d2-6e10-44de-8162-bc8611d65ee6,44017266,6933,6818,115,108
408,21fdce87-e698-49c7-bf62-7aa2ac03220c,43995168,72,0,-72,0
408,21fdce87-e698-49c7-bf62-7aa2ac03220c,43995168,96,1,95,1
408,21fdce87-e698-49c7-bf62-7aa2ac03220c,43995168,655,102,553,2
408,21fdce87-e698-49c7-bf62-7aa2ac03220c,43995168,1274,673,601,3
408,21fdce87-e698-49c7-bf62-7aa2ac03220c,43995168,2337,1304,1033,4
408,21fdce87-e698-49c7-bf62-7aa2ac03220c,43995168,2335,1793,-542,7
408,21fdce87-e698-49c7-bf62-7aa2ac03220c,43995168,1770,976,-794,8
408,21fdce87-e698-49c7-bf62-7aa2ac03220c,43995168,958,275,-683,9
408,21fdce87-e698-49c7-bf62-7aa2ac03220c,43995168,267,69,-198,10
408,21fdce87-e698-49c7-bf62-7aa2ac03220c,43995168,61,0,-61,11
408,21fdce87-e698-49c7-bf62-7aa2ac03220c,44005724,57,1,56,0
408,21fdce87-e698-49c7-bf62-7aa2ac03220c,44005724,130,59,71,1
408,21fdce87-e698-49c7-bf62-7aa2ac03220c,44005724,419,146,273,2
408,21fdce87-e698-49c7-bf62-7aa2ac03220c,44005724,1115,445,670,3
408,21fdce87-e698-49c7-bf62-7aa2ac03220c,44005724,1348,1117,231,4
408,21fdce87-e698-49c7-bf62-7aa2ac03220c,44005724,2516,1392,1124,5
408,21fdce87-e698-49c7-bf62-7aa2ac03220c,44021829,21,3,18,0
408,21fdce87-e698-49c7-bf62-7aa2ac03220c,44021829,145,23,122,1
408,21fdce87-e698-49c7-bf62-7aa2ac03220c,44021829,257,146,111,2
408,21fdce87-e698-49c7-bf62-7aa2ac03220c,44021829,402,267,135,3
408,21fdce87-e698-49c7-bf62-7aa2ac03220c,44021829,405,403,2,4
408,21fdce87-e698-49c7-bf62-7aa2ac03220c,44021829,464,406,58,5
408,21fdce87-e698-49c7-bf62-7aa2ac03220c,44021829,523,466,57,6
408,21fdce87-e698-49c7-bf62-7aa2ac03220c,44021829,584,524,60,7
408,21fdce87-e698-49c7-bf62-7aa2ac03220c,44021829,631,586,45,11
408,21fdce87-e698-49c7-bf62-7aa2ac03220c,44021829,846,635,211,17
408,21fdce87-e698-49c7-bf62-7aa2ac03220c,44021829,844,646,-198,19
408,21fdce87-e698-49c7-bf62-7aa2ac03220c,44021829,823,650,173,25
408,21fdce87-e698-49c7-bf62-7aa2ac03220c,44021829,1069,830,239,26
408,21fdce87-e698-49c7-bf62-7aa2ac03220c,44021829,1873,0,-1873,27
408,21fdce87-e698-49c7-bf62-7aa2ac03220c,44021829,156,156,0,30
408,21fdce87-e698-49c7-bf62-7aa2ac03220c,44021829,929,167,762,31
408,21fdce87-e698-49c7-bf62-7aa2ac03220c,44021829,817,755,-62,32
408,21fdce87-e698-49c7-bf62-7aa2ac03220c,44021829,753,526,-227,33
408,21fdce87-e698-49c7-bf62-7aa2ac03220c,44021829,1072,537,535,35
406,f7731d6e-7886-4695-8fd7-36f170dc6562,44007709,285,16,269,0
406,f7731d6e-7886-4695-8fd7-36f170dc6562,44007709,983,312,671,1
406,f7731d6e-7886-4695-8fd7-36f170dc6562,44007709,1038,986,52,18
406,f7731d6e-7886-4695-8fd7-36f170dc6562,44007709,1038,1034,4,19
406,f7731d6e-7886-4695-8fd7-36f170dc6562,44007709,1040,1039,1,20
406,f7731d6e-7886-4695-8fd7-36f170dc6562,44007709,1181,1051,130,26
406,f7731d6e-7886-4695-8fd7-36f170dc6562,44007709,1216,1191,25,27
406,f7731d6e-7886-4695-8fd7-36f170dc6562,44007709,1227,1218,9,39
406,f7731d6e-7886-4695-8fd7-36f170dc6562,44007709,1226,924,-302,40
406,f7731d6e-7886-4695-8fd7-36f170dc6562,44007709,928,916,12,41
406,f7731d6e-7886-4695-8fd7-36f170dc6562,43987148,308,3,305,0
406,f7731d6e-7886-4695-8fd7-36f170dc6562,43987148,723,310,413,1
406,f7731d6e-7886-4695-8fd7-36f170dc6562,43987148,1283,729,554,2
406,f7731d6e-7886-4695-8fd7-36f170dc6562,43987148,1678,1309,369,22
406,f7731d6e-7886-4695-8fd7-36f170dc6562,43987148,1676,1675,-1,23
406,f7731d6e-7886-4695-8fd7-36f170dc6562,43987148,1676,1675,1,23
406,f7731d6e-7886-4695-8fd7-36f170dc6562,43987148,2080,1700,380,43
406,f7731d6e-7886-4695-8fd7-36f170dc6562,43987148,2577,2096,481,44
406,f7731d6e-7886-4695-8fd7-36f170dc6562,43987148,2964,2605,359,62
406,f7731d6e-7886-4695-8fd7-36f170dc6562,43987148,3055,2969,86,63
406,f7731d6e-7886-4695-8fd7-36f170dc6562,43987148,3660,3090,570,67
406,f7731d6e-7886-4695-8fd7-36f170dc6562,43987148,3685,3665,20,68
406,f7731d6e-7886-4695-8fd7-36f170dc6562,43987148,3945,3748,197,71
406,f7731d6e-7886-4695-8fd7-36f170dc6562,43987148,4330,3961,369,72
406,f7731d6e-7886-4695-8fd7-36f170dc6562,43987148,4896,4364,532,77
406,f7731d6e-7886-4695-8fd7-36f170dc6562,43987148,4854,4762,-92,87
406,f7731d6e-7886-4695-8fd7-36f170dc6562,43987148,4793,4727,66,88
406,f7731d6e-7886-4695-8fd7-36f170dc6562,43987148,4807,4795,12,89
406,f7731d6e-7886-4695-8fd7-36f170dc6562,43987148,4772,4132,-640,103
406,f7731d6e-7886-4695-8fd7-36f170dc6562,44021119,1204,72,1132,0
406,f7731d6e-7886-4695-8fd7-36f170dc6562,44021119,1415,1148,-267,1
406,f7731d6e-7886-4695-8fd7-36f170dc6562,44021119,1097,710,-387,2
406,f7731d6e-7886-4695-8fd7-36f170dc6562,44021119,661,329,-332,6
406,f7731d6e-7886-4695-8fd7-36f170dc6562,44021119,326,0,-326,7
406,f7731d6e-7886-4695-8fd7-36f170dc6562,44021119,65,5,60,8
406,f7731d6e-7886-4695-8fd7-36f170dc6562,44021119,625,59,566,9
406,f7731d6e-7886-4695-8fd7-36f170dc6562,44021119,626,622,4,10
406,f7731d6e-7886-4695-8fd7-36f170dc6562,44021119,634,627,7,11
406,f7731d6e-7886-4695-8fd7-36f170dc6562,44021119,679,635,44,12
406,f7731d6e-7886-4695-8fd7-36f170dc6562,44021119,718,678,40,13
406,f7731d6e-7886-4695-8fd7-36f170dc6562,44021119,981,732,249,14
406,f7731d6e-7886-4695-8fd7-36f170dc6562,44021119,1965,983,982,15
406,f7731d6e-7886-4695-8fd7-36f170dc6562,44021119,2230,2005,225,32
406,f7731d6e-7886-4695-8fd7-36f170dc6562,44021119,2331,2244,87,34
406,f7731d6e-7886-4695-8fd7-36f170dc6562,44021119,2551,2334,217,35
406,f7731d6e-7886-4695-8fd7-36f170dc6562,44021119,2578,2552,26,36
406,f7731d6e-7886-4695-8fd7-36f170dc6562,44021119,2572,2571,1,37
406,f7731d6e-7886-4695-8fd7-36f170dc6562,44021119,2572,2571,-1,37
406,f7731d6e-7886-4695-8fd7-36f170dc6562,44021119,2587,2570,17,38
406,f7731d6e-7886-4695-8fd7-36f170dc6562,44021119,2625,2589,36,39
406,f7731d6e-7886-4695-8fd7-36f170dc6562,44021119,2638,2626,12,40
406,f7731d6e-7886-4695-8fd7-36f170dc6562,44021119,2651,2637,14,41
406,f7731d6e-7886-4695-8fd7-36f170dc6562,44021119,3141,2652,489,42
406,f7731d6e-7886-4695-8fd7-36f170dc6562,44021119,4278,3173,1105,43
406,f7731d6e-7886-4695-8fd7-36f170dc6562,44021119,4382,4290,92,44
406,f7731d6e-7886-4695-8fd7-36f170dc6562,44021119,4448,4384,64,45
406,f7731d6e-7886-4695-8fd7-36f170dc6562,44021119,4813,4460,353,54
406,f7731d6e-7886-4695-8fd7-36f170dc6562,44021119,4998,4838,160,55
406,f7731d6e-7886-4695-8fd7-36f170dc6562,44021119,5006,5001,5,56
406,f7731d6e-7886-4695-8fd7-36f170dc6562,44021119,5222,5015,207,58
406,f7731d6e-7886-4695-8fd7-36f170dc6562,44021119,5822,5224,598,59
406,f7731d6e-7886-4695-8fd7-36f170dc6562,44021119,6241,5831,410,60
406,f7731d6e-7886-4695-8fd7-36f170dc6562,44021119,6516,6253,263,61
406,f7731d6e-7886-4695-8fd7-36f170dc6562,44021119,6615,6524,91,80
406,f7731d6e-7886-4695-8fd7-36f170dc6562,44021119,6823,6623,200,81
406,f7731d6e-7886-4695-8fd7-36f170dc6562,44021119,7005,6833,172,82
406,f7731d6e-7886-4695-8fd7-36f170dc6562,44021119,7082,7034,48,110
406,f7731d6e-7886-4695-8fd7-36f170dc6562,44021119,7528,7116,412,111
406,f7731d6e-7886-4695-8fd7-36f170dc6562,44021119,7736,7529,207,112
406,f7731d6e-7886-4695-8fd7-36f170dc6562,44021119,7735,7733,-2,113
406,f7731d6e-7886-4695-8fd7-36f170dc6562,44021119,7800,7737,63,119
406,f7731d6e-7886-4695-8fd7-36f170dc6562,44021119,8223,7821,402,126
406,f7731d6e-7886-4695-8fd7-36f170dc6562,44021119,8749,8234,515,127
406,f7731d6e-7886-4695-8fd7-36f170dc6562,44021119,9152,8762,390,132
406,f7731d6e-7886-4695-8fd7-36f170dc6562,44021119,9245,9160,85,133
406,f7731d6e-7886-4695-8fd7-36f170dc6562,44021119,9313,9313,0,135
406,f7731d6e-7886-4695-8fd7-36f170dc6562,44021119,9573,9382,191,136
406,f7731d6e-7886-4695-8fd7-36f170dc6562,44021119,9882,9627,255,139
406,f7731d6e-7886-4695-8fd7-36f170dc6562,44021119,10043,9912,131,144
406,f7731d6e-7886-4695-8fd7-36f170dc6562,44021119,10041,10041,0,145
406,f7731d6e-7886-4695-8fd7-36f170dc6562,44021119,10250,10059,191,149
406,f7731d6e-7886-4695-8fd7-36f170dc6562,44021119,10599,10251,348,154
406,f7731d6e-7886-4695-8fd7-36f170dc6562,44021119,10900,10612,288,156
406,f7731d6e-7886-4695-8fd7-36f170dc6562,44021119,11015,10910,105,157
406,f7731d6e-7886-4695-8fd7-36f170dc6562,44021119,11345,11014,331,158
406,f7731d6e-7886-4695-8fd7-36f170dc6562,44021119,11445,11350,95,159
406,f7731d6e-7886-4695-8fd7-36f170dc6562,44021119,11560,11462,98,164
406,f7731d6e-7886-4695-8fd7-36f170dc6562,44021119,11636,11560,76,165
406,f7731d6e-7886-4695-8fd7-36f170dc6562,44021119,11888,11638,250,169
406,f7731d6e-7886-4695-8fd7-36f170dc6562,44021119,12135,11928,207,170
406,f7731d6e-7886-4695-8fd7-36f170dc6562,44021119,12381,12139,242,171
406,f7731d6e-7886-4695-8fd7-36f170dc6562,44021119,12381,12380,1,172
406,f7731d6e-7886-4695-8fd7-36f170dc6562,44021119,12374,12337,-37,181
406,f7731d6e-7886-4695-8fd7-36f170dc6562,44021119,12324,11617,-707,186
406,f7731d6e-7886-4695-8fd7-36f170dc6562,44021119,11560,10909,-651,187
407,8e68de20-e181-42c9-95bd-4a6fd890f4a9,44026796,161,3,158,0
407,8e68de20-e181-42c9-95bd-4a6fd890f4a9,44026796,236,169,67,1
407,8e68de20-e181-42c9-95bd-4a6fd890f4a9,44026796,253,239,14,2
407,8e68de20-e181-42c9-95bd-4a6fd890f4a9,44026796,376,255,121,3
407,8e68de20-e181-42c9-95bd-4a6fd890f4a9,44026796,546,383,163,4
407,8e68de20-e181-42c9-95bd-4a6fd890f4a9,44026796,619,550,69,5
407,8e68de20-e181-42c9-95bd-4a6fd890f4a9,44026796,726,621,105,6
407,8e68de20-e181-42c9-95bd-4a6fd890f4a9,44026796,803,734,69,7
407,8e68de20-e181-42c9-95bd-4a6fd890f4a9,44026796,1030,804,226,8
407,8e68de20-e181-42c9-95bd-4a6fd890f4a9,44026796,1115,1035,80,9
407,8e68de20-e181-42c9-95bd-4a6fd890f4a9,44026796,1555,1132,423,10
407,8e68de20-e181-42c9-95bd-4a6fd890f4a9,44026796,1664,1559,105,11
407,8e68de20-e181-42c9-95bd-4a6fd890f4a9,44026796,1738,1668,70,12
407,8e68de20-e181-42c9-95bd-4a6fd890f4a9,44026796,1793,1739,54,13
407,8e68de20-e181-42c9-95bd-4a6fd890f4a9,44026796,2128,1799,329,14
407,8e68de20-e181-42c9-95bd-4a6fd890f4a9,44026796,2783,2130,653,15
407,8e68de20-e181-42c9-95bd-4a6fd890f4a9,44026796,2844,2788,56,16
407,8e68de20-e181-42c9-95bd-4a6fd890f4a9,44026796,2872,2848,24,17
407,8e68de20-e181-42c9-95bd-4a6fd890f4a9,44026796,2883,2876,7,18
407,8e68de20-e181-42c9-95bd-4a6fd890f4a9,44026796,2909,2885,24,19
407,8e68de20-e181-42c9-95bd-4a6fd890f4a9,44026796,3068,2919,149,21
407,8e68de20-e181-42c9-95bd-4a6fd890f4a9,44026796,3598,3075,523,22
407,8e68de20-e181-42c9-95bd-4a6fd890f4a9,44026796,3683,3599,84,23
407,8e68de20-e181-42c9-95bd-4a6fd890f4a9,44026796,3721,3693,28,24
407,8e68de20-e181-42c9-95bd-4a6fd890f4a9,44026796,3808,0,-3808,25
407,8e68de20-e181-42c9-95bd-4a6fd890f4a9,43939015,113,0,-113,0
407,8e68de20-e181-42c9-95bd-4a6fd890f4a9,43939015,565,7,558,2
407,8e68de20-e181-42c9-95bd-4a6fd890f4a9,43939015,999,607,392,3
407,8e68de20-e181-42c9-95bd-4a6fd890f4a9,43939015,1182,1001,181,4
407,8e68de20-e181-42c9-95bd-4a6fd890f4a9,43939015,1936,1186,750,5
407,8e68de20-e181-42c9-95bd-4a6fd890f4a9,43939015,1951,1180,-771,6
407,8e68de20-e181-42c9-95bd-4a6fd890f4a9,43939015,1178,1177,-1,7
407,8e68de20-e181-42c9-95bd-4a6fd890f4a9,43939015,1146,657,-489,17
407,8e68de20-e181-42c9-95bd-4a6fd890f4a9,43939015,638,0,-638,18
407,8e68de20-e181-42c9-95bd-4a6fd890f4a9,43939015,932,4,928,19
407,8e68de20-e181-42c9-95bd-4a6fd890f4a9,43939015,959,939,20,20
407,8e68de20-e181-42c9-95bd-4a6fd890f4a9,44023381,272,11,261,0
407,8e68de20-e181-42c9-95bd-4a6fd890f4a9,44023381,401,284,117,1
407,8e68de20-e181-42c9-95bd-4a6fd890f4a9,44023381,444,409,35,2
407,8e68de20-e181-42c9-95bd-4a6fd890f4a9,44023381,468,447,21,3
407,8e68de20-e181-42c9-95bd-4a6fd890f4a9,44023381,572,471,101,10
407,8e68de20-e181-42c9-95bd-4a6fd890f4a9,44023381,675,579,96,11
407,8e68de20-e181-42c9-95bd-4a6fd890f4a9,44023381,696,679,17,12
407,8e68de20-e181-42c9-95bd-4a6fd890f4a9,44023381,726,698,28,16
407,8e68de20-e181-42c9-95bd-4a6fd890f4a9,44023381,734,728,6,17
407,8e68de20-e181-42c9-95bd-4a6fd890f4a9,44023381,765,736,29,18
407,8e68de20-e181-42c9-95bd-4a6fd890f4a9,44023381,916,774,142,19
407,8e68de20-e181-42c9-95bd-4a6fd890f4a9,44023381,1261,927,334,20
407,8e68de20-e181-42c9-95bd-4a6fd890f4a9,44023381,1511,1272,239,21
407,8e68de20-e181-42c9-95bd-4a6fd890f4a9,44023381,1578,1514,64,22
407,8e68de20-e181-42c9-95bd-4a6fd890f4a9,44023381,1627,1585,42,23
407,8e68de20-e181-42c9-95bd-4a6fd890f4a9,44023381,1677,1628,49,24
407,8e68de20-e181-42c9-95bd-4a6fd890f4a9,44023381,2203,1683,520,25
407,8e68de20-e181-42c9-95bd-4a6fd890f4a9,44023381,2744,2214,530,26
407,8e68de20-e181-42c9-95bd-4a6fd890f4a9,44023381,3353,2747,606,27
407,8e68de20-e181-42c9-95bd-4a6fd890f4a9,44023381,3708,3358,350,28
407,8e68de20-e181-42c9-95bd-4a6fd890f4a9,44023381,3837,3714,123,29
407,a968156b-94ac-4274-9a76-b2310e8f8822,44028663,849,7,842,0
407,a968156b-94ac-4274-9a76-b2310e8f8822,44028663,921,861,60,1
407,a968156b-94ac-4274-9a76-b2310e8f8822,44028663,1078,931,147,2
407,a968156b-94ac-4274-9a76-b2310e8f8822,44028663,1128,1082,46,3
407,a968156b-94ac-4274-9a76-b2310e8f8822,44028663,1350,1134,216,4
407,a968156b-94ac-4274-9a76-b2310e8f8822,44028663,1826,1361,465,5
407,a968156b-94ac-4274-9a76-b2310e8f8822,44028663,2050,1830,220,6
407,a968156b-94ac-4274-9a76-b2310e8f8822,44028663,2520,2066,454,7
407,a968156b-94ac-4274-9a76-b2310e8f8822,44028663,3313,2526,787,8
407,a968156b-94ac-4274-9a76-b2310e8f8822,44028663,4049,3320,729,9
407,a968156b-94ac-4274-9a76-b2310e8f8822,44028663,5072,4052,1020,10
407,a968156b-94ac-4274-9a76-b2310e8f8822,44028663,5579,5106,473,11
407,a968156b-94ac-4274-9a76-b2310e8f8822,44028663,5871,5585,286,12
407,fed87984-63c4-4486-a6d5-2610c192cfad,44017266,2,2,0,0
407,fed87984-63c4-4486-a6d5-2610c192cfad,44017266,100,8,92,1
407,fed87984-63c4-4486-a6d5-2610c192cfad,44017266,684,101,583,2
407,fed87984-63c4-4486-a6d5-2610c192cfad,44017266,811,688,123,3
407,fed87984-63c4-4486-a6d5-2610c192cfad,44017266,889,820,69,4
407,fed87984-63c4-4486-a6d5-2610c192cfad,44017266,1135,891,244,5
407,fed87984-63c4-4486-a6d5-2610c192cfad,44017266,1304,1138,166,6
407,fed87984-63c4-4486-a6d5-2610c192cfad,44017266,1424,1312,112,7
407,fed87984-63c4-4486-a6d5-2610c192cfad,44017266,1983,1428,555,8
407,fed87984-63c4-4486-a6d5-2610c192cfad,44017266,2471,1986,485,9
407,fed87984-63c4-4486-a6d5-2610c192cfad,44017266,2555,2487,68,10
407,fed87984-63c4-4486-a6d5-2610c192cfad,44017266,2870,2562,308,13
407,fed87984-63c4-4486-a6d5-2610c192cfad,44017266,3763,2930,833,14
407,fed87984-63c4-4486-a6d5-2610c192cfad,44017266,5055,3800,1255,15
407,fed87984-63c4-4486-a6d5-2610c192cfad,44017266,6041,5056,985,16
407,fed87984-63c4-4486-a6d5-2610c192cfad,44017266,7233,6078,1155,17
407,fed87984-63c4-4486-a6d5-2610c192cfad,43992782,331,13,318,0
407,fed87984-63c4-4486-a6d5-2610c192cfad,43992782,424,343,81,1
407,fed87984-63c4-4486-a6d5-2610c192cfad,43992782,491,429,62,2
407,fed87984-63c4-4486-a6d5-2610c192cfad,43992782,532,492,40,3
407,fed87984-63c4-4486-a6d5-2610c192cfad,43992782,567,533,34,5
407,fed87984-63c4-4486-a6d5-2610c192cfad,43992782,844,583,261,6
407,fed87984-63c4-4486-a6d5-2610c192cfad,43992782,918,845,73,7
407,fed87984-63c4-4486-a6d5-2610c192cfad,43992782,1298,936,362,8
407,fed87984-63c4-4486-a6d5-2610c192cfad,43992782,1882,1341,541,9
407,fed87984-63c4-4486-a6d5-2610c192cfad,43992782,2330,1918,412,10
407,fed87984-63c4-4486-a6d5-2610c192cfad,43992782,2400,2332,68,15
407,fed87984-63c4-4486-a6d5-2610c192cfad,43992782,2561,2402,159,16
407,fed87984-63c4-4486-a6d5-2610c192cfad,43992782,2745,2569,176,17
407,fed87984-63c4-4486-a6d5-2610c192cfad,43992782,2913,2751,162,18
407,fed87984-63c4-4486-a6d5-2610c192cfad,43992782,3004,2914,90,19
407,fed87984-63c4-4486-a6d5-2610c192cfad,43992782,3066,3010,56,20
407,fed87984-63c4-4486-a6d5-2610c192cfad,43992782,3164,3069,95,21
407,fed87984-63c4-4486-a6d5-2610c192cfad,43992782,3258,3173,85,22
407,fed87984-63c4-4486-a6d5-2610c192cfad,43992782,3360,3265,95,23
407,fed87984-63c4-4486-a6d5-2610c192cfad,43992782,3428,3369,59,24
407,fed87984-63c4-4486-a6d5-2610c192cfad,43992782,3595,3440,155,25
407,fed87984-63c4-4486-a6d5-2610c192cfad,43992782,3726,3602,124,26
407,fed87984-63c4-4486-a6d5-2610c192cfad,43992782,3728,3727,1,27
407,fed87984-63c4-4486-a6d5-2610c192cfad,43992782,3830,3736,94,28
407,fed87984-63c4-4486-a6d5-2610c192cfad,43992782,3883,3836,47,29
407,fed87984-63c4-4486-a6d5-2610c192cfad,43992782,5335,3890,1445,30
407,fed87984-63c4-4486-a6d5-2610c192cfad,43992782,6496,5397,1099,31
407,fed87984-63c4-4486-a6d5-2610c192cfad,43992782,6510,6510,0,32
407,fed87984-63c4-4486-a6d5-2610c192cfad,43992782,6479,6287,-192,34
406,ee13fd8e-9627-402e-9d3e-07d6f09c8597,44023381,79,2,77,0
406,ee13fd8e-9627-402e-9d3e-07d6f09c8597,44023381,165,79,86,1
406,ee13fd8e-9627-402e-9d3e-07d6f09c8597,44023381,507,180,327,2
406,ee13fd8e-9627-402e-9d3e-07d6f09c8597,44023381,517,517,0,11
406,ee13fd8e-9627-402e-9d3e-07d6f09c8597,44023381,559,519,40,12
406,ee13fd8e-9627-402e-9d3e-07d6f09c8597,44023381,673,557,116,13
406,ee13fd8e-9627-402e-9d3e-07d6f09c8597,44023381,1033,683,350,14
406,ee13fd8e-9627-402e-9d3e-07d6f09c8597,44023381,1255,1039,216,35
406,ee13fd8e-9627-402e-9d3e-07d6f09c8597,44023381,1477,1258,219,40
406,ee13fd8e-9627-402e-9d3e-07d6f09c8597,44023381,1558,1481,77,41
406,ee13fd8e-9627-402e-9d3e-07d6f09c8597,44023381,1648,1559,89,49
406,ee13fd8e-9627-402e-9d3e-07d6f09c8597,44023381,2108,1656,452,50
406,ee13fd8e-9627-402e-9d3e-07d6f09c8597,44023381,2100,1962,-138,51
406,ee13fd8e-9627-402e-9d3e-07d6f09c8597,44023381,2152,1980,172,54
406,ee13fd8e-9627-402e-9d3e-07d6f09c8597,44023381,2441,2168,273,55
406,ee13fd8e-9627-402e-9d3e-07d6f09c8597,44023381,2683,2452,231,60
406,ee13fd8e-9627-402e-9d3e-07d6f09c8597,44023381,3537,2700,837,61
406,ee13fd8e-9627-402e-9d3e-07d6f09c8597,44017266,249,18,231,0
406,ee13fd8e-9627-402e-9d3e-07d6f09c8597,44017266,463,256,207,1
406,ee13fd8e-9627-402e-9d3e-07d6f09c8597,44017266,553,468,85,2
406,ee13fd8e-9627-402e-9d3e-07d6f09c8597,44017266,711,555,156,3
406,ee13fd8e-9627-402e-9d3e-07d6f09c8597,44017266,886,717,169,10
406,ee13fd8e-9627-402e-9d3e-07d6f09c8597,44017266,1014,891,123,11
406,ee13fd8e-9627-402e-9d3e-07d6f09c8597,44017266,1093,1018,75,13
406,ee13fd8e-9627-402e-9d3e-07d6f09c8597,44017266,1102,1094,8,14
406,ee13fd8e-9627-402e-9d3e-07d6f09c8597,44017266,1180,1104,76,15
406,ee13fd8e-9627-402e-9d3e-07d6f09c8597,44017266,1369,1181,188,16
406,ee13fd8e-9627-402e-9d3e-07d6f09c8597,44017266,1396,1374,22,17
406,ee13fd8e-9627-402e-9d3e-07d6f09c8597,44017266,1422,1402,20,18
406,ee13fd8e-9627-402e-9d3e-07d6f09c8597,44017266,1672,1436,236,23
406,ee13fd8e-9627-402e-9d3e-07d6f09c8597,44017266,1682,1678,4,24
406,ee13fd8e-9627-402e-9d3e-07d6f09c8597,44017266,1944,1686,258,30
406,ee13fd8e-9627-402e-9d3e-07d6f09c8597,44017266,2209,1957,252,35
406,ee13fd8e-9627-402e-9d3e-07d6f09c8597,44017266,2233,2217,16,36
406,ee13fd8e-9627-402e-9d3e-07d6f09c8597,44017266,2269,2245,24,60
406,ee13fd8e-9627-402e-9d3e-07d6f09c8597,44017266,2302,2277,25,61
406,ee13fd8e-9627-402e-9d3e-07d6f09c8597,44017266,2391,2307,84,64
406,ee13fd8e-9627-402e-9d3e-07d6f09c8597,44017266,2434,2400,34,65
406,ee13fd8e-9627-402e-9d3e-07d6f09c8597,44017266,2522,2437,85,90
406,ee13fd8e-9627-402e-9d3e-07d6f09c8597,44017266,2626,2545,81,91
406,ee13fd8e-9627-402e-9d3e-07d6f09c8597,44017266,2933,2627,306,92
406,ee13fd8e-9627-402e-9d3e-07d6f09c8597,44017266,3089,2935,154,93
406,ee13fd8e-9627-402e-9d3e-07d6f09c8597,44017266,3928,3099,829,94
406,ee13fd8e-9627-402e-9d3e-07d6f09c8597,44017266,4667,3932,735,95
406,ee13fd8e-9627-402e-9d3e-07d6f09c8597,44017266,4635,4407,-228,96
406,ee13fd8e-9627-402e-9d3e-07d6f09c8597,44017266,4403,4027,-376,97
406,ee13fd8e-9627-402e-9d3e-07d6f09c8597,44017266,4049,4030,19,102
406,ee13fd8e-9627-402e-9d3e-07d6f09c8597,44017266,4244,4053,191,103
406,ee13fd8e-9627-402e-9d3e-07d6f09c8597,44017266,4559,4249,310,104
406,ee13fd8e-9627-402e-9d3e-07d6f09c8597,44017266,4747,4563,184,105
406,ee13fd8e-9627-402e-9d3e-07d6f09c8597,44017266,4796,4748,48,106
406,ee13fd8e-9627-402e-9d3e-07d6f09c8597,44017266,4911,4797,114,107
406,ee13fd8e-9627-402e-9d3e-07d6f09c8597,44017266,5008,4912,96,114
406,ee13fd8e-9627-402e-9d3e-07d6f09c8597,44017266,5284,5009,275,115
406,ee13fd8e-9627-402e-9d3e-07d6f09c8597,44017266,5560,5291,269,116
406,ee13fd8e-9627-402e-9d3e-07d6f09c8597,44017266,6336,5570,766,117
406,ee13fd8e-9627-402e-9d3e-07d6f09c8597,44017266,6387,6348,39,118
406,ee13fd8e-9627-402e-9d3e-07d6f09c8597,44017266,6308,4329,-1979,119
406,ee13fd8e-9627-402e-9d3e-07d6f09c8597,44017266,4302,2017,-2285,120
406,ee13fd8e-9627-402e-9d3e-07d6f09c8597,44017266,1989,228,-1761,121
406,ee13fd8e-9627-402e-9d3e-07d6f09c8597,44017266,211,0,-211,122
406,ee13fd8e-9627-402e-9d3e-07d6f09c8597,44017266,832,57,775,126
406,ee13fd8e-9627-402e-9d3e-07d6f09c8597,44017266,894,0,-894,127
406,ee13fd8e-9627-402e-9d3e-07d6f09c8597,44017266,3549,79,3470,130
406,ee13fd8e-9627-402e-9d3e-07d6f09c8597,44017266,4698,3641,1057,131
406,ee13fd8e-9627-402e-9d3e-07d6f09c8597,44017266,6387,4708,1679,132
406,ee13fd8e-9627-402e-9d3e-07d6f09c8597,44017266,0,0,0,135
406,ee13fd8e-9627-402e-9d3e-07d6f09c8597,44027773,86,9,77,0
406,ee13fd8e-9627-402e-9d3e-07d6f09c8597,44027773,367,88,279,1
406,ee13fd8e-9627-402e-9d3e-07d6f09c8597,44027773,809,371,438,2
406,ee13fd8e-9627-402e-9d3e-07d6f09c8597,44027773,942,813,129,3
406,ee13fd8e-9627-402e-9d3e-07d6f09c8597,44027773,944,940,4,4
406,ee13fd8e-9627-402e-9d3e-07d6f09c8597,44027773,947,944,3,5
406,ee13fd8e-9627-402e-9d3e-07d6f09c8597,44027773,969,949,20,6
406,ee13fd8e-9627-402e-9d3e-07d6f09c8597,44027773,1030,969,61,7
406,ee13fd8e-9627-402e-9d3e-07d6f09c8597,44027773,1069,1032,37,8
406,ee13fd8e-9627-402e-9d3e-07d6f09c8597,44027773,1093,1070,23,9
406,ee13fd8e-9627-402e-9d3e-07d6f09c8597,44027773,1118,1095,23,10
406,ee13fd8e-9627-402e-9d3e-07d6f09c8597,44027773,1159,1119,40,11
406,ee13fd8e-9627-402e-9d3e-07d6f09c8597,44027773,1225,1160,65,12
406,ee13fd8e-9627-402e-9d3e-07d6f09c8597,44027773,1300,1227,73,25
406,ee13fd8e-9627-402e-9d3e-07d6f09c8597,44027773,1364,1303,61,26
406,ee13fd8e-9627-402e-9d3e-07d6f09c8597,44027773,1406,1370,36,51
406,ee13fd8e-9627-402e-9d3e-07d6f09c8597,44006176,378,11,367,0
406,ee13fd8e-9627-402e-9d3e-07d6f09c8597,44006176,524,380,144,1
406,ee13fd8e-9627-402e-9d3e-07d6f09c8597,44006176,606,526,80,2
406,ee13fd8e-9627-402e-9d3e-07d6f09c8597,44006176,808,610,198,3
406,ee13fd8e-9627-402e-9d3e-07d6f09c8597,44006176,941,819,122,4
406,ee13fd8e-9627-402e-9d3e-07d6f09c8597,44006176,1433,960,473,15
406,ee13fd8e-9627-402e-9d3e-07d6f09c8597,44006176,1434,1434,0,16
406,ee13fd8e-9627-402e-9d3e-07d6f09c8597,44006176,1444,1438,6,24
406,ee13fd8e-9627-402e-9d3e-07d6f09c8597,44006176,1528,1444,84,25
406,ee13fd8e-9627-402e-9d3e-07d6f09c8597,44006176,1527,1527,0,26
406,ee13fd8e-9627-402e-9d3e-07d6f09c8597,44006176,1566,1528,38,27
406,ee13fd8e-9627-402e-9d3e-07d6f09c8597,44006176,1608,1563,45,28
406,ee13fd8e-9627-402e-9d3e-07d6f09c8597,44006176,1632,1609,23,29
406,ee13fd8e-9627-402e-9d3e-07d6f09c8597,44006176,1838,1640,198,32
406,ee13fd8e-9627-402e-9d3e-07d6f09c8597,44006176,2103,1840,263,42
406,ee13fd8e-9627-402e-9d3e-07d6f09c8597,44006176,2255,2107,148,51
406,ee13fd8e-9627-402e-9d3e-07d6f09c8597,44006176,2321,2272,49,58
406,ee13fd8e-9627-402e-9d3e-07d6f09c8597,44006176,2541,2328,213,59
406,ee13fd8e-9627-402e-9d3e-07d6f09c8597,44006176,2561,2543,18,60
406,ee13fd8e-9627-402e-9d3e-07d6f09c8597,44006176,2510,2345,-165,67
406,ee13fd8e-9627-402e-9d3e-07d6f09c8597,44006176,2325,2016,-309,68
406,ee13fd8e-9627-402e-9d3e-07d6f09c8597,44006176,2015,2015,0,70
406,ee13fd8e-9627-402e-9d3e-07d6f09c8597,44006176,2199,2017,182,71
406,ee13fd8e-9627-402e-9d3e-07d6f09c8597,44006176,2448,2202,246,72
406,ee13fd8e-9627-402e-9d3e-07d6f09c8597,44006176,2624,2457,167,87
406,ee13fd8e-9627-402e-9d3e-07d6f09c8597,44006176,2956,2634,322,88
406,ee13fd8e-9627-402e-9d3e-07d6f09c8597,44006176,3218,2961,257,94
406,ee13fd8e-9627-402e-9d3e-07d6f09c8597,44006176,3347,3222,125,95
406,ee13fd8e-9627-402e-9d3e-07d6f09c8597,44006176,3361,3343,18,96
406,ee13fd8e-9627-402e-9d3e-07d6f09c8597,44006176,3497,3362,135,97
406,ee13fd8e-9627-402e-9d3e-07d6f09c8597,44006176,3671,3499,172,98
406,ee13fd8e-9627-402e-9d3e-07d6f09c8597,44006176,3781,3674,107,99
406,ee13fd8e-9627-402e-9d3e-07d6f09c8597,44006176,4523,3769,754,100
406,ee13fd8e-9627-402e-9d3e-07d6f09c8597,44006176,4908,4527,381,101
406,ee13fd8e-9627-402e-9d3e-07d6f09c8597,43968765,1196,29,1167,0
406,ee13fd8e-9627-402e-9d3e-07d6f09c8597,43968765,2001,1259,742,1
406,ee13fd8e-9627-402e-9d3e-07d6f09c8597,43968765,1797,508,-1289,2
406,ee13fd8e-9627-402e-9d3e-07d6f09c8597,43968765,1009,833,176,3
406,ee13fd8e-9627-402e-9d3e-07d6f09c8597,43968765,1512,1043,469,9
406,ee13fd8e-9627-402e-9d3e-07d6f09c8597,43968765,1514,1513,1,10
406,ee13fd8e-9627-402e-9d3e-07d6f09c8597,43968765,1646,1518,128,15
406,ee13fd8e-9627-402e-9d3e-07d6f09c8597,43968765,1666,1650,16,17
406,ee13fd8e-9627-402e-9d3e-07d6f09c8597,43968765,1753,1667,86,19
406,ee13fd8e-9627-402e-9d3e-07d6f09c8597,43968765,1886,1756,130,20
406,ee13fd8e-9627-402e-9d3e-07d6f09c8597,43968765,1912,1888,24,21
406,ee13fd8e-9627-402e-9d3e-07d6f09c8597,43968765,1916,1913,3,22
406,ee13fd8e-9627-402e-9d3e-07d6f09c8597,43968765,1915,1842,-73,23
406,ee13fd8e-9627-402e-9d3e-07d6f09c8597,43968765,1844,1793,-51,24
406,ee13fd8e-9627-402e-9d3e-07d6f09c8597,43968765,2215,1701,514,25
406,ee13fd8e-9627-402e-9d3e-07d6f09c8597,43968765,2566,2225,341,26
406,ee13fd8e-9627-402e-9d3e-07d6f09c8597,43968765,2568,2567,1,27
406,ee13fd8e-9627-402e-9d3e-07d6f09c8597,43968765,2747,2571,176,31
406,ee13fd8e-9627-402e-9d3e-07d6f09c8597,43968765,2923,2750,173,32
406,ee13fd8e-9627-402e-9d3e-07d6f09c8597,43968765,3039,2943,96,33
406,ee13fd8e-9627-402e-9d3e-07d6f09c8597,43968765,5004,3111,1893,34
406,ee13fd8e-9627-402e-9d3e-07d6f09c8597,43968765,5959,5012,947,35
406,ee13fd8e-9627-402e-9d3e-07d6f09c8597,43968765,6702,5972,730,36
406,ee13fd8e-9627-402e-9d3e-07d6f09c8597,43968765,6753,6731,22,37
406,ee13fd8e-9627-402e-9d3e-07d6f09c8597,43968765,6751,6654,-97,38
406,ee13fd8e-9627-402e-9d3e-07d6f09c8597,43968765,6628,5504,-1124,39
406,ee13fd8e-9627-402e-9d3e-07d6f09c8597,43968765,5487,5344,-143,40
406,ee13fd8e-9627-402e-9d3e-07d6f09c8597,43968765,5465,5346,119,41
406,ee13fd8e-9627-402e-9d3e-07d6f09c8597,43968765,5670,5468,202,42
406,ee13fd8e-9627-402e-9d3e-07d6f09c8597,43968765,5714,5672,42,43
406,ee13fd8e-9627-402e-9d3e-07d6f09c8597,43968765,6311,5749,562,57
406,ee13fd8e-9627-402e-9d3e-07d6f09c8597,43968765,6753,6317,436,58
406,ee13fd8e-9627-402e-9d3e-07d6f09c8597,43981165,1,1,0,0
406,ee13fd8e-9627-402e-9d3e-07d6f09c8597,43981165,1393,13,1380,1
406,ee13fd8e-9627-402e-9d3e-07d6f09c8597,43981165,3088,1433,1655,2
406,ee13fd8e-9627-402e-9d3e-07d6f09c8597,43981165,4515,3116,1399,3
406,ee13fd8e-9627-402e-9d3e-07d6f09c8597,43981165,4493,1486,-3007,4
406,ee13fd8e-9627-402e-9d3e-07d6f09c8597,43981165,1459,764,-695,5
406,ee13fd8e-9627-402e-9d3e-07d6f09c8597,43981165,766,765,1,8
406,ee13fd8e-9627-402e-9d3e-07d6f09c8597,43981165,828,764,64,9
406,ee13fd8e-9627-402e-9d3e-07d6f09c8597,43981165,877,820,57,10
406,ee13fd8e-9627-402e-9d3e-07d6f09c8597,43981165,911,883,28,11
406,ee13fd8e-9627-402e-9d3e-07d6f09c8597,43981165,1014,910,104,14
406,ee13fd8e-9627-402e-9d3e-07d6f09c8597,43981165,1056,1017,39,15
406,ee13fd8e-9627-402e-9d3e-07d6f09c8597,43981165,1202,1059,143,20
406,ee13fd8e-9627-402e-9d3e-07d6f09c8597,43981165,1311,1209,102,21
406,ee13fd8e-9627-402e-9d3e-07d6f09c8597,43981165,1359,1316,43,27
406,ee13fd8e-9627-402e-9d3e-07d6f09c8597,43981165,1636,1368,268,28
406,ee13fd8e-9627-402e-9d3e-07d6f09c8597,43981165,1845,1644,201,29
406,ee13fd8e-9627-402e-9d3e-07d6f09c8597,43981165,1853,1848,5,30
406,ee13fd8e-9627-402e-9d3e-07d6f09c8597,43981165,1859,1856,3,31
406,ee13fd8e-9627-402e-9d3e-07d6f09c8597,43981165,1861,1860,1,34
406,ee13fd8e-9627-402e-9d3e-07d6f09c8597,43981165,1997,1863,134,35
406,ee13fd8e-9627-402e-9d3e-07d6f09c8597,43981165,2045,1998,47,36
406,ee13fd8e-9627-402e-9d3e-07d6f09c8597,43981165,2224,2047,177,37
406,ee13fd8e-9627-402e-9d3e-07d6f09c8597,43981165,2262,2226,36,38
406,ee13fd8e-9627-402e-9d3e-07d6f09c8597,43981165,2314,2268,46,42
406,ee13fd8e-9627-402e-9d3e-07d6f09c8597,43981165,2316,2315,1,43
406,ee13fd8e-9627-402e-9d3e-07d6f09c8597,43981165,2398,2318,80,44
406,ee13fd8e-9627-402e-9d3e-07d6f09c8597,43981165,2483,2399,84,45
406,ee13fd8e-9627-402e-9d3e-07d6f09c8597,43981165,2579,2484,95,46
406,ee13fd8e-9627-402e-9d3e-07d6f09c8597,43981165,2657,2581,76,47
406,ee13fd8e-9627-402e-9d3e-07d6f09c8597,43981165,2714,2658,56,49
406,ee13fd8e-9627-402e-9d3e-07d6f09c8597,43981165,2805,2713,92,50
406,ee13fd8e-9627-402e-9d3e-07d6f09c8597,43981165,2908,2807,101,51
406,ee13fd8e-9627-402e-9d3e-07d6f09c8597,43981165,3113,2916,197,52
406,ee13fd8e-9627-402e-9d3e-07d6f09c8597,43981165,3114,3114,0,53
406,ee13fd8e-9627-402e-9d3e-07d6f09c8597,43981165,3140,3113,27,55
406,ee13fd8e-9627-402e-9d3e-07d6f09c8597,43981165,3142,3138,-4,56
406,ee13fd8e-9627-402e-9d3e-07d6f09c8597,43981165,3137,3137,0,57
406,ee13fd8e-9627-402e-9d3e-07d6f09c8597,43981165,3254,3136,118,58
406,ee13fd8e-9627-402e-9d3e-07d6f09c8597,43981165,3434,3260,174,59
406,ee13fd8e-9627-402e-9d3e-07d6f09c8597,43981165,3661,3442,219,60
406,ee13fd8e-9627-402e-9d3e-07d6f09c8597,43981165,3688,3670,18,65
406,ee13fd8e-9627-402e-9d3e-07d6f09c8597,43981165,4515,3692,823,66
406,ee13fd8e-9627-402e-9d3e-07d6f09c8597,43981165,4515,4513,-2,84
406,ee13fd8e-9627-402e-9d3e-07d6f09c8597,43981165,4515,4511,-4,85
406,ee13fd8e-9627-402e-9d3e-07d6f09c8597,43981165,4515,4501,-14,89
406,ee13fd8e-9627-402e-9d3e-07d6f09c8597,43981165,4500,4493,-7,90
409,4361e0e2-052a-495f-86a2-c93e7eccc23c,44005013,154,6,148,0
409,4361e0e2-052a-495f-86a2-c93e7eccc23c,44005013,260,0,260,1
409,4361e0e2-052a-495f-86a2-c93e7eccc23c,44005013,793,273,520,2
409,4361e0e2-052a-495f-86a2-c93e7eccc23c,44005013,1286,844,442,3
409,4361e0e2-052a-495f-86a2-c93e7eccc23c,44005013,1468,1288,180,4
409,4361e0e2-052a-495f-86a2-c93e7eccc23c,44005013,1623,1480,143,5
409,4361e0e2-052a-495f-86a2-c93e7eccc23c,44005013,1698,1626,72,8
409,4361e0e2-052a-495f-86a2-c93e7eccc23c,44005013,1750,1701,49,9
409,4361e0e2-052a-495f-86a2-c93e7eccc23c,44005013,1819,1758,61,10
409,4361e0e2-052a-495f-86a2-c93e7eccc23c,44005013,1921,1820,101,11
409,4361e0e2-052a-495f-86a2-c93e7eccc23c,44005013,2068,1923,145,23
409,4361e0e2-052a-495f-86a2-c93e7eccc23c,44005013,2189,2068,121,30
409,4361e0e2-052a-495f-86a2-c93e7eccc23c,44005013,2236,2198,38,31
409,4361e0e2-052a-495f-86a2-c93e7eccc23c,44005013,2386,2245,141,33
409,4361e0e2-052a-495f-86a2-c93e7eccc23c,44005013,2576,2387,189,38
409,4361e0e2-052a-495f-86a2-c93e7eccc23c,44005013,2682,2568,114,39
409,4361e0e2-052a-495f-86a2-c93e7eccc23c,44005013,2793,2684,109,41
409,4361e0e2-052a-495f-86a2-c93e7eccc23c,44005013,2926,2795,131,45
409,4361e0e2-052a-495f-86a2-c93e7eccc23c,44005013,3067,2930,137,47
409,4361e0e2-052a-495f-86a2-c93e7eccc23c,44005013,3190,3077,113,48
409,4361e0e2-052a-495f-86a2-c93e7eccc23c,44005013,3200,3193,7,49
409,4361e0e2-052a-495f-86a2-c93e7eccc23c,44005013,3330,3208,122,55
409,4361e0e2-052a-495f-86a2-c93e7eccc23c,44005013,3426,3331,95,56
409,4361e0e2-052a-495f-86a2-c93e7eccc23c,44005013,3537,3431,106,57
409,4361e0e2-052a-495f-86a2-c93e7eccc23c,44005013,3802,3546,256,58
409,4361e0e2-052a-495f-86a2-c93e7eccc23c,44005013,4220,3808,412,59
409,4361e0e2-052a-495f-86a2-c93e7eccc23c,44005013,4307,4231,76,60
409,4361e0e2-052a-495f-86a2-c93e7eccc23c,44005013,4757,4316,441,92
409,4361e0e2-052a-495f-86a2-c93e7eccc23c,44005013,5178,4760,418,93
409,4361e0e2-052a-495f-86a2-c93e7eccc23c,44005013,5328,5187,141,94
409,ae46fb17-524b-45a8-bf18-4f001d47cdba,44027773,149,12,137,0
409,ae46fb17-524b-45a8-bf18-4f001d47cdba,44027773,160,153,7,1
409,ae46fb17-524b-45a8-bf18-4f001d47cdba,44027773,317,172,145,2
409,ae46fb17-524b-45a8-bf18-4f001d47cdba,44027773,312,0,-312,6
409,ae46fb17-524b-45a8-bf18-4f001d47cdba,44027773,219,2,217,15
409,ae46fb17-524b-45a8-bf18-4f001d47cdba,44027773,464,225,239,16
409,ae46fb17-524b-45a8-bf18-4f001d47cdba,44027773,504,474,30,17
409,ae46fb17-524b-45a8-bf18-4f001d47cdba,44027773,497,45,-452,19
409,ae46fb17-524b-45a8-bf18-4f001d47cdba,44027773,39,20,-19,20
409,ae46fb17-524b-45a8-bf18-4f001d47cdba,44027773,71,25,46,21
409,ae46fb17-524b-45a8-bf18-4f001d47cdba,44027773,732,122,610,22
409,ae46fb17-524b-45a8-bf18-4f001d47cdba,44027773,950,735,215,23
409,ae46fb17-524b-45a8-bf18-4f001d47cdba,44027773,1135,960,175,25
409,ae46fb17-524b-45a8-bf18-4f001d47cdba,44027773,1302,1138,164,26
409,ae46fb17-524b-45a8-bf18-4f001d47cdba,44027773,1524,1304,220,33
409,ae46fb17-524b-45a8-bf18-4f001d47cdba,44027773,1780,1531,249,34
409,ae46fb17-524b-45a8-bf18-4f001d47cdba,44027773,1881,1779,102,35
409,ae46fb17-524b-45a8-bf18-4f001d47cdba,44027773,1978,1895,83,36
409,ae46fb17-524b-45a8-bf18-4f001d47cdba,44027773,2218,1979,239,37
409,ae46fb17-524b-45a8-bf18-4f001d47cdba,44027773,2744,2235,509,38
409,ae46fb17-524b-45a8-bf18-4f001d47cdba,44027773,2762,2754,8,39
407,f8700433-35d8-4aa0-b1f2-63d8b88715a0,44032295,157,2,155,0
407,f8700433-35d8-4aa0-b1f2-63d8b88715a0,44032295,388,162,226,1
407,f8700433-35d8-4aa0-b1f2-63d8b88715a0,44032295,503,396,107,2
407,f8700433-35d8-4aa0-b1f2-63d8b88715a0,44032295,772,506,266,4
407,f8700433-35d8-4aa0-b1f2-63d8b88715a0,44032295,1027,773,254,5
407,f8700433-35d8-4aa0-b1f2-63d8b88715a0,44032295,1135,1033,102,6
407,f8700433-35d8-4aa0-b1f2-63d8b88715a0,44032295,1242,1147,95,7
407,f8700433-35d8-4aa0-b1f2-63d8b88715a0,44032295,1601,1252,349,8
407,f8700433-35d8-4aa0-b1f2-63d8b88715a0,44032295,1921,1622,299,13
407,f8700433-35d8-4aa0-b1f2-63d8b88715a0,44032295,2508,1953,555,14
407,f8700433-35d8-4aa0-b1f2-63d8b88715a0,44032295,2483,0,-2483,15
407,f8700433-35d8-4aa0-b1f2-63d8b88715a0,44028366,7,7,0,0
407,f8700433-35d8-4aa0-b1f2-63d8b88715a0,44028366,45,15,30,1
407,f8700433-35d8-4aa0-b1f2-63d8b88715a0,44028366,547,50,497,2
407,f8700433-35d8-4aa0-b1f2-63d8b88715a0,44028366,608,565,43,4
407,f8700433-35d8-4aa0-b1f2-63d8b88715a0,44028366,641,617,24,5
407,f8700433-35d8-4aa0-b1f2-63d8b88715a0,44028366,726,646,80,7
407,f8700433-35d8-4aa0-b1f2-63d8b88715a0,44028366,783,738,45,8
407,f8700433-35d8-4aa0-b1f2-63d8b88715a0,44028366,1288,810,478,9
407,f8700433-35d8-4aa0-b1f2-63d8b88715a0,44028366,2368,1339,1029,10
407,f8700433-35d8-4aa0-b1f2-63d8b88715a0,44028366,2448,2378,70,11
407,f8700433-35d8-4aa0-b1f2-63d8b88715a0,44003853,325,11,314,0
407,f8700433-35d8-4aa0-b1f2-63d8b88715a0,44003853,515,330,185,1
407,f8700433-35d8-4aa0-b1f2-63d8b88715a0,44003853,642,519,123,2
407,f8700433-35d8-4aa0-b1f2-63d8b88715a0,44003853,790,653,137,3
407,f8700433-35d8-4aa0-b1f2-63d8b88715a0,44003853,883,805,78,4
407,f8700433-35d8-4aa0-b1f2-63d8b88715a0,44003853,959,896,63,6
407,f8700433-35d8-4aa0-b1f2-63d8b88715a0,44003853,1362,979,383,12
407,f8700433-35d8-4aa0-b1f2-63d8b88715a0,44003853,1539,1376,163,13
407,f8700433-35d8-4aa0-b1f2-63d8b88715a0,44003853,2297,1568,729,14
407,f8700433-35d8-4aa0-b1f2-63d8b88715a0,44003853,2518,2311,207,16
407,f8700433-35d8-4aa0-b1f2-63d8b88715a0,44003853,2668,2520,148,17
407,f8700433-35d8-4aa0-b1f2-63d8b88715a0,44003853,2794,2674,120,18
407,f8700433-35d8-4aa0-b1f2-63d8b88715a0,44003853,3155,2814,341,19
407,f8700433-35d8-4aa0-b1f2-63d8b88715a0,44003853,3247,3161,86,20
407,f8700433-35d8-4aa0-b1f2-63d8b88715a0,44003853,4106,3261,845,78
407,f8700433-35d8-4aa0-b1f2-63d8b88715a0,44003853,4107,4107,0,79
407,f8700433-35d8-4aa0-b1f2-63d8b88715a0,44026548,32,1,31,0
407,f8700433-35d8-4aa0-b1f2-63d8b88715a0,44026548,34,33,1,1
407,f8700433-35d8-4aa0-b1f2-63d8b88715a0,44026548,357,50,307,3
407,f8700433-35d8-4aa0-b1f2-63d8b88715a0,44026548,425,371,54,4
407,f8700433-35d8-4aa0-b1f2-63d8b88715a0,44026548,574,450,124,6
407,f8700433-35d8-4aa0-b1f2-63d8b88715a0,44026548,953,576,377,7
407,f8700433-35d8-4aa0-b1f2-63d8b88715a0,44026548,1102,955,147,8
407,f8700433-35d8-4aa0-b1f2-63d8b88715a0,44026548,1169,1106,63,9
407,f8700433-35d8-4aa0-b1f2-63d8b88715a0,44026548,1274,1179,95,10
407,f8700433-35d8-4aa0-b1f2-63d8b88715a0,44026548,1315,1275,40,11
407,f8700433-35d8-4aa0-b1f2-63d8b88715a0,44026548,1317,1317,0,12
407,f8700433-35d8-4aa0-b1f2-63d8b88715a0,44026548,1477,1333,144,13
407,f8700433-35d8-4aa0-b1f2-63d8b88715a0,44005013,205,14,191,0
407,f8700433-35d8-4aa0-b1f2-63d8b88715a0,44005013,209,206,3,1
407,f8700433-35d8-4aa0-b1f2-63d8b88715a0,44005013,538,227,311,2
407,f8700433-35d8-4aa0-b1f2-63d8b88715a0,44005013,761,547,214,3
407,f8700433-35d8-4aa0-b1f2-63d8b88715a0,44005013,947,763,184,4
407,f8700433-35d8-4aa0-b1f2-63d8b88715a0,44005013,963,948,15,5
407,f8700433-35d8-4aa0-b1f2-63d8b88715a0,44005013,1153,967,186,6
407,f8700433-35d8-4aa0-b1f2-63d8b88715a0,44005013,1371,1157,214,7
407,f8700433-35d8-4aa0-b1f2-63d8b88715a0,44005013,1468,1373,95,8
407,f8700433-35d8-4aa0-b1f2-63d8b88715a0,44005013,1513,1470,43,9
407,f8700433-35d8-4aa0-b1f2-63d8b88715a0,44005013,1558,1516,42,10
407,f8700433-35d8-4aa0-b1f2-63d8b88715a0,44005013,1612,1561,51,11
407,f8700433-35d8-4aa0-b1f2-63d8b88715a0,44005013,1684,1624,60,12
407,f8700433-35d8-4aa0-b1f2-63d8b88715a0,44005013,1719,1690,29,13
407,f8700433-35d8-4aa0-b1f2-63d8b88715a0,44005013,1760,1727,33,14
407,f8700433-35d8-4aa0-b1f2-63d8b88715a0,44005013,1826,1775,51,15
407,f8700433-35d8-4aa0-b1f2-63d8b88715a0,44005013,1978,1829,149,16
407,f8700433-35d8-4aa0-b1f2-63d8b88715a0,44005013,2040,1981,59,17
407,f8700433-35d8-4aa0-b1f2-63d8b88715a0,44005013,2092,2051,41,18
407,f8700433-35d8-4aa0-b1f2-63d8b88715a0,44005013,2206,2100,106,20
407,f8700433-35d8-4aa0-b1f2-63d8b88715a0,44005013,2503,2215,288,21
407,f8700433-35d8-4aa0-b1f2-63d8b88715a0,44005013,2800,2507,293,22
407,f8700433-35d8-4aa0-b1f2-63d8b88715a0,44005013,2847,2803,44,24
407,f8700433-35d8-4aa0-b1f2-63d8b88715a0,44005013,2971,2851,120,25
407,f8700433-35d8-4aa0-b1f2-63d8b88715a0,44005013,3168,2981,187,26
407,f8700433-35d8-4aa0-b1f2-63d8b88715a0,44005013,3586,3184,402,27
407,f8700433-35d8-4aa0-b1f2-63d8b88715a0,44005013,6199,3650,2549,28
407,f8700433-35d8-4aa0-b1f2-63d8b88715a0,44005013,7437,6201,1236,29
407,f8700433-35d8-4aa0-b1f2-63d8b88715a0,44005013,7427,7158,-269,30
407,f8700433-35d8-4aa0-b1f2-63d8b88715a0,44005013,7144,7074,-70,31
407,f8700433-35d8-4aa0-b1f2-63d8b88715a0,44029224,141,16,125,0
407,f8700433-35d8-4aa0-b1f2-63d8b88715a0,44029224,255,144,111,1
407,f8700433-35d8-4aa0-b1f2-63d8b88715a0,44029224,316,267,49,2
407,f8700433-35d8-4aa0-b1f2-63d8b88715a0,44029224,433,328,105,3
407,f8700433-35d8-4aa0-b1f2-63d8b88715a0,44029224,699,451,248,4
407,f8700433-35d8-4aa0-b1f2-63d8b88715a0,44029224,1205,711,494,5
407,f8700433-35d8-4aa0-b1f2-63d8b88715a0,44029224,1209,1207,2,6
407,f8700433-35d8-4aa0-b1f2-63d8b88715a0,44029224,1639,1246,393,18
407,557462e7-be73-426c-8284-a2ef9fc0001f,44034532,561,15,546,0
407,557462e7-be73-426c-8284-a2ef9fc0001f,44034532,784,565,219,1
407,557462e7-be73-426c-8284-a2ef9fc0001f,44034532,898,789,109,2
407,557462e7-be73-426c-8284-a2ef9fc0001f,44034532,959,903,56,3
407,557462e7-be73-426c-8284-a2ef9fc0001f,44034532,1012,967,45,6
407,557462e7-be73-426c-8284-a2ef9fc0001f,44034532,1115,1016,99,7
407,557462e7-be73-426c-8284-a2ef9fc0001f,44034532,1197,1120,77,9
407,557462e7-be73-426c-8284-a2ef9fc0001f,44034532,1246,1204,42,10
407,557462e7-be73-426c-8284-a2ef9fc0001f,44034532,1344,1254,90,11
407,557462e7-be73-426c-8284-a2ef9fc0001f,44034532,1398,1348,50,12
407,557462e7-be73-426c-8284-a2ef9fc0001f,44034532,1560,1410,150,13
409,8f7f1eba-f95d-40ed-8d13-5ef110e46727,44047113,386,1,385,0
409,8f7f1eba-f95d-40ed-8d13-5ef110e46727,44047113,560,394,166,1
409,8f7f1eba-f95d-40ed-8d13-5ef110e46727,44047113,706,573,133,2
409,8f7f1eba-f95d-40ed-8d13-5ef110e46727,44047113,978,709,269,3
409,8f7f1eba-f95d-40ed-8d13-5ef110e46727,44047113,1085,987,98,4
409,8f7f1eba-f95d-40ed-8d13-5ef110e46727,44047113,1255,1095,160,5
409,8f7f1eba-f95d-40ed-8d13-5ef110e46727,44047113,1410,1258,152,6
409,8f7f1eba-f95d-40ed-8d13-5ef110e46727,44047113,1478,1414,64,7
409,8f7f1eba-f95d-40ed-8d13-5ef110e46727,44047113,1533,1487,46,8
409,8f7f1eba-f95d-40ed-8d13-5ef110e46727,44047113,1699,1543,156,9
409,8f7f1eba-f95d-40ed-8d13-5ef110e46727,44047113,1814,1702,112,10
409,8f7f1eba-f95d-40ed-8d13-5ef110e46727,44047113,1817,1815,2,11
409,8f7f1eba-f95d-40ed-8d13-5ef110e46727,44047113,1878,1823,55,12
409,8f7f1eba-f95d-40ed-8d13-5ef110e46727,44047113,1964,1885,79,16
409,8f7f1eba-f95d-40ed-8d13-5ef110e46727,44047113,2047,1966,81,17
409,8f7f1eba-f95d-40ed-8d13-5ef110e46727,44047113,2118,2045,73,18
409,8f7f1eba-f95d-40ed-8d13-5ef110e46727,44047113,2097,1753,-344,19
409,8f7f1eba-f95d-40ed-8d13-5ef110e46727,44047113,1786,1765,21,22
409,8f7f1eba-f95d-40ed-8d13-5ef110e46727,44047113,1969,1798,171,23
409,8f7f1eba-f95d-40ed-8d13-5ef110e46727,44047113,2061,1970,91,24
409,8f7f1eba-f95d-40ed-8d13-5ef110e46727,44047113,2248,2069,179,25
409,8f7f1eba-f95d-40ed-8d13-5ef110e46727,44047113,2356,2252,104,26
409,8f7f1eba-f95d-40ed-8d13-5ef110e46727,44047113,2450,2360,90,27
409,8f7f1eba-f95d-40ed-8d13-5ef110e46727,44047113,2465,2454,11,28
409,8f7f1eba-f95d-40ed-8d13-5ef110e46727,44047113,2513,2466,47,30
409,8f7f1eba-f95d-40ed-8d13-5ef110e46727,44047113,2562,2518,44,31
409,8f7f1eba-f95d-40ed-8d13-5ef110e46727,44047113,4860,2612,2248,32
409,8f7f1eba-f95d-40ed-8d13-5ef110e46727,44047113,4858,4858,0,41
409,8f7f1eba-f95d-40ed-8d13-5ef110e46727,44047113,4860,4860,0,42
409,8f7f1eba-f95d-40ed-8d13-5ef110e46727,44047113,4847,4598,-249,43
409,8f7f1eba-f95d-40ed-8d13-5ef110e46727,44047113,4860,4601,259,44
409,8f7f1eba-f95d-40ed-8d13-5ef110e46727,44039616,352,1,351,0
409,8f7f1eba-f95d-40ed-8d13-5ef110e46727,44039616,516,350,166,1
409,8f7f1eba-f95d-40ed-8d13-5ef110e46727,44039616,609,517,92,2
409,8f7f1eba-f95d-40ed-8d13-5ef110e46727,44039616,692,611,81,3
409,8f7f1eba-f95d-40ed-8d13-5ef110e46727,44039616,651,0,-651,4
409,8f7f1eba-f95d-40ed-8d13-5ef110e46727,44039616,640,10,630,26
409,8f7f1eba-f95d-40ed-8d13-5ef110e46727,44039616,991,662,329,27
409,8f7f1eba-f95d-40ed-8d13-5ef110e46727,44039616,1299,971,328,28
409,8f7f1eba-f95d-40ed-8d13-5ef110e46727,44039616,1473,1315,158,29
409,8f7f1eba-f95d-40ed-8d13-5ef110e46727,44039616,1573,1476,97,30
409,8f7f1eba-f95d-40ed-8d13-5ef110e46727,44039616,1542,0,-1542,32
409,8f7f1eba-f95d-40ed-8d13-5ef110e46727,44039616,76,13,63,34
409,8f7f1eba-f95d-40ed-8d13-5ef110e46727,44039616,62,0,-62,35
409,8f7f1eba-f95d-40ed-8d13-5ef110e46727,44039616,377,28,349,36
409,8f7f1eba-f95d-40ed-8d13-5ef110e46727,44039616,860,378,482,37
409,8f7f1eba-f95d-40ed-8d13-5ef110e46727,44039616,1007,861,146,38
409,8f7f1eba-f95d-40ed-8d13-5ef110e46727,44039616,1310,1010,300,39
409,8f7f1eba-f95d-40ed-8d13-5ef110e46727,44039616,1465,1311,154,40
409,8f7f1eba-f95d-40ed-8d13-5ef110e46727,44039616,1596,1479,117,41
409,8f7f1eba-f95d-40ed-8d13-5ef110e46727,44039616,1704,1598,106,42
409,8f7f1eba-f95d-40ed-8d13-5ef110e46727,44039616,1846,1706,140,44
409,8f7f1eba-f95d-40ed-8d13-5ef110e46727,44039616,1926,1853,73,45
409,8f7f1eba-f95d-40ed-8d13-5ef110e46727,44039616,2076,1927,149,46
409,8f7f1eba-f95d-40ed-8d13-5ef110e46727,44039616,2188,2077,111,47
409,8f7f1eba-f95d-40ed-8d13-5ef110e46727,44039616,2303,2189,114,48
409,8f7f1eba-f95d-40ed-8d13-5ef110e46727,44039616,2413,2307,106,50
409,8f7f1eba-f95d-40ed-8d13-5ef110e46727,44039616,2403,2284,-119,51
409,8f7f1eba-f95d-40ed-8d13-5ef110e46727,44039616,2410,2298,112,53
409,8f7f1eba-f95d-40ed-8d13-5ef110e46727,44039616,2535,2414,121,54
409,8f7f1eba-f95d-40ed-8d13-5ef110e46727,44039616,2780,2537,243,55
409,8f7f1eba-f95d-40ed-8d13-5ef110e46727,44039616,2804,2787,17,56
409,8f7f1eba-f95d-40ed-8d13-5ef110e46727,44038086,213,4,209,0
409,8f7f1eba-f95d-40ed-8d13-5ef110e46727,44038086,579,233,346,1
409,8f7f1eba-f95d-40ed-8d13-5ef110e46727,44038086,874,586,288,2
409,8f7f1eba-f95d-40ed-8d13-5ef110e46727,44038086,1124,875,249,3
409,8f7f1eba-f95d-40ed-8d13-5ef110e46727,44038086,1534,1128,406,4
409,8f7f1eba-f95d-40ed-8d13-5ef110e46727,44038086,1852,1543,309,5
409,8f7f1eba-f95d-40ed-8d13-5ef110e46727,44038086,2496,1869,627,6
409,8f7f1eba-f95d-40ed-8d13-5ef110e46727,44038086,2969,2515,454,7
409,8f7f1eba-f95d-40ed-8d13-5ef110e46727,44038086,3172,2977,195,8
409,8f7f1eba-f95d-40ed-8d13-5ef110e46727,44038086,3373,3176,197,10
409,8f7f1eba-f95d-40ed-8d13-5ef110e46727,44038086,3495,3390,105,11
409,8f7f1eba-f95d-40ed-8d13-5ef110e46727,44038086,3598,3499,99,12
409,8f7f1eba-f95d-40ed-8d13-5ef110e46727,44038086,3710,3607,103,14
409,8f7f1eba-f95d-40ed-8d13-5ef110e46727,44038086,5142,3722,1420,15
409,8f7f1eba-f95d-40ed-8d13-5ef110e46727,44038086,5636,5179,457,16
409,8f7f1eba-f95d-40ed-8d13-5ef110e46727,44038086,6040,5631,409,17
409,8f7f1eba-f95d-40ed-8d13-5ef110e46727,44038086,6281,6046,235,18
409,8f7f1eba-f95d-40ed-8d13-5ef110e46727,44038086,7594,6346,1248,19
409,8f7f1eba-f95d-40ed-8d13-5ef110e46727,44038086,7916,7602,314,20
409,8f7f1eba-f95d-40ed-8d13-5ef110e46727,44038086,8419,7931,488,21
409,8f7f1eba-f95d-40ed-8d13-5ef110e46727,44038086,8574,8419,155,22
409,8f7f1eba-f95d-40ed-8d13-5ef110e46727,44038086,8786,8583,203,23
409,8f7f1eba-f95d-40ed-8d13-5ef110e46727,44038086,9057,8776,281,24
409,8f7f1eba-f95d-40ed-8d13-5ef110e46727,44038086,9067,9058,9,25
409,8f7f1eba-f95d-40ed-8d13-5ef110e46727,44038086,9158,9067,91,26
409,8f7f1eba-f95d-40ed-8d13-5ef110e46727,44038086,9198,9162,36,27
409,8f7f1eba-f95d-40ed-8d13-5ef110e46727,44038086,11280,9203,2077,28
409,8f7f1eba-f95d-40ed-8d13-5ef110e46727,44038086,11445,11294,151,29
409,8f7f1eba-f95d-40ed-8d13-5ef110e46727,44038086,11593,11447,146,30
409,8f7f1eba-f95d-40ed-8d13-5ef110e46727,44038086,11684,11601,83,31
409,8f7f1eba-f95d-40ed-8d13-5ef110e46727,44038086,14275,11705,2570,32
409,8f7f1eba-f95d-40ed-8d13-5ef110e46727,44038086,14317,14279,38,33
409,8f7f1eba-f95d-40ed-8d13-5ef110e46727,44038086,14421,14317,104,34
409,8f7f1eba-f95d-40ed-8d13-5ef110e46727,44038086,15490,14422,1068,35
409,8f7f1eba-f95d-40ed-8d13-5ef110e46727,44038086,15487,14676,-811,36
409,8f7f1eba-f95d-40ed-8d13-5ef110e46727,44038086,16954,14673,2281,37
409,8f7f1eba-f95d-40ed-8d13-5ef110e46727,44038086,17182,16968,214,38
409,8f7f1eba-f95d-40ed-8d13-5ef110e46727,44038086,17227,17175,52,39
409,8f7f1eba-f95d-40ed-8d13-5ef110e46727,44038086,17268,17231,37,40
409,8f7f1eba-f95d-40ed-8d13-5ef110e46727,44038086,17353,17271,82,41
409,8f7f1eba-f95d-40ed-8d13-5ef110e46727,44038086,17349,17263,-86,42
409,8f7f1eba-f95d-40ed-8d13-5ef110e46727,44038086,17478,17297,181,45
409,8f7f1eba-f95d-40ed-8d13-5ef110e46727,44038086,19316,17484,1832,46
407,6b114d4e-8d1c-4231-b6b7-375c35069c86,44049532,100,6,94,0
407,6b114d4e-8d1c-4231-b6b7-375c35069c86,44049532,241,103,138,1
407,6b114d4e-8d1c-4231-b6b7-375c35069c86,44049532,309,247,62,2
407,6b114d4e-8d1c-4231-b6b7-375c35069c86,44049532,483,258,-225,3
407,6b114d4e-8d1c-4231-b6b7-375c35069c86,44049532,266,0,266,4
407,6b114d4e-8d1c-4231-b6b7-375c35069c86,44049532,399,277,122,5
407,6b114d4e-8d1c-4231-b6b7-375c35069c86,44049532,598,401,197,6
407,6b114d4e-8d1c-4231-b6b7-375c35069c86,44049532,922,614,308,7
407,6b114d4e-8d1c-4231-b6b7-375c35069c86,44049532,1536,930,606,8
407,6b114d4e-8d1c-4231-b6b7-375c35069c86,44049532,1658,1548,110,9
407,6b114d4e-8d1c-4231-b6b7-375c35069c86,44049532,1760,1664,96,10
407,6b114d4e-8d1c-4231-b6b7-375c35069c86,44049532,1986,1767,219,12
407,6b114d4e-8d1c-4231-b6b7-375c35069c86,44049532,3421,2021,1400,13
407,6b114d4e-8d1c-4231-b6b7-375c35069c86,44049532,3846,3479,367,14
407,6b114d4e-8d1c-4231-b6b7-375c35069c86,44049532,3634,3574,-60,15
407,6b114d4e-8d1c-4231-b6b7-375c35069c86,44046358,156,5,151,0
407,6b114d4e-8d1c-4231-b6b7-375c35069c86,44046358,150,0,-150,5
407,6b114d4e-8d1c-4231-b6b7-375c35069c86,44046358,156,0,-156,6
407,6b114d4e-8d1c-4231-b6b7-375c35069c86,44046358,156,13,143,8
407,6b114d4e-8d1c-4231-b6b7-375c35069c86,44039666,201,7,194,0
407,6b114d4e-8d1c-4231-b6b7-375c35069c86,44039666,350,204,146,2
407,6b114d4e-8d1c-4231-b6b7-375c35069c86,44039666,404,356,48,9
407,6b114d4e-8d1c-4231-b6b7-375c35069c86,44039666,478,407,71,10
407,6b114d4e-8d1c-4231-b6b7-375c35069c86,44039666,570,486,84,11
407,6b114d4e-8d1c-4231-b6b7-375c35069c86,44039666,739,571,168,12
407,6b114d4e-8d1c-4231-b6b7-375c35069c86,44039666,1022,740,282,13
407,6b114d4e-8d1c-4231-b6b7-375c35069c86,44039666,1131,1026,105,17
407,6b114d4e-8d1c-4231-b6b7-375c35069c86,44039666,1342,1134,208,21
407,6b114d4e-8d1c-4231-b6b7-375c35069c86,44039666,1410,1348,62,23
407,6b114d4e-8d1c-4231-b6b7-375c35069c86,44039666,1560,1414,146,24
407,6b114d4e-8d1c-4231-b6b7-375c35069c86,44039666,1739,1569,170,25
407,6b114d4e-8d1c-4231-b6b7-375c35069c86,44039666,2095,1750,345,26
407,6b114d4e-8d1c-4231-b6b7-375c35069c86,44039666,2330,2102,228,27
407,6b114d4e-8d1c-4231-b6b7-375c35069c86,44039666,2331,2331,0,28
407,6b114d4e-8d1c-4231-b6b7-375c35069c86,44039666,2426,2342,84,36
407,6b114d4e-8d1c-4231-b6b7-375c35069c86,44039666,2667,2431,236,37
407,6b114d4e-8d1c-4231-b6b7-375c35069c86,44039666,2685,2673,12,38
407,6b114d4e-8d1c-4231-b6b7-375c35069c86,44039666,2710,2690,20,39
407,6b114d4e-8d1c-4231-b6b7-375c35069c86,44039666,2797,2713,84,40
407,6b114d4e-8d1c-4231-b6b7-375c35069c86,44039666,2854,2799,55,42
407,6b114d4e-8d1c-4231-b6b7-375c35069c86,44039666,2881,2857,24,43
407,6b114d4e-8d1c-4231-b6b7-375c35069c86,44039666,3019,2886,133,46
407,6b114d4e-8d1c-4231-b6b7-375c35069c86,44039666,3063,3030,33,47
407,6b114d4e-8d1c-4231-b6b7-375c35069c86,44039666,3286,3065,221,50
407,6b114d4e-8d1c-4231-b6b7-375c35069c86,44039666,3389,3291,98,53
407,6b114d4e-8d1c-4231-b6b7-375c35069c86,44039666,3411,3394,17,54
407,6b114d4e-8d1c-4231-b6b7-375c35069c86,44039666,3496,3417,79,55
407,6b114d4e-8d1c-4231-b6b7-375c35069c86,44039666,3900,3509,391,56
407,6b114d4e-8d1c-4231-b6b7-375c35069c86,44039666,4173,3910,263,57
407,6b114d4e-8d1c-4231-b6b7-375c35069c86,44039666,5186,4195,991,58
407,6b114d4e-8d1c-4231-b6b7-375c35069c86,44039666,5384,5210,174,59
407,6b114d4e-8d1c-4231-b6b7-375c35069c86,44039666,5595,5425,170,74
407,6b114d4e-8d1c-4231-b6b7-375c35069c86,44039666,5870,5621,249,75
407,6b114d4e-8d1c-4231-b6b7-375c35069c86,44039666,7580,5906,1674,76
407,6b114d4e-8d1c-4231-b6b7-375c35069c86,44039666,7953,7609,344,77
407,6b114d4e-8d1c-4231-b6b7-375c35069c86,44039666,8088,7962,126,78
407,6b114d4e-8d1c-4231-b6b7-375c35069c86,44039666,8446,8093,353,79
407,6b114d4e-8d1c-4231-b6b7-375c35069c86,44039666,8500,8450,50,81
407,6b114d4e-8d1c-4231-b6b7-375c35069c86,44039666,9170,8501,669,82
407,6b114d4e-8d1c-4231-b6b7-375c35069c86,44039666,10849,9194,1655,83
407,6b114d4e-8d1c-4231-b6b7-375c35069c86,44039666,11091,10872,219,84
407,6b114d4e-8d1c-4231-b6b7-375c35069c86,44039666,11080,10823,-257,87
407,6b114d4e-8d1c-4231-b6b7-375c35069c86,44044248,108,6,102,0
407,6b114d4e-8d1c-4231-b6b7-375c35069c86,44044248,124,114,10,1
407,6b114d4e-8d1c-4231-b6b7-375c35069c86,44044248,179,129,50,2
407,6b114d4e-8d1c-4231-b6b7-375c35069c86,44044248,348,182,166,3
407,6b114d4e-8d1c-4231-b6b7-375c35069c86,44044248,487,352,135,4
407,6b114d4e-8d1c-4231-b6b7-375c35069c86,44044248,823,488,335,5
407,6b114d4e-8d1c-4231-b6b7-375c35069c86,44044248,1251,829,422,6
407,6b114d4e-8d1c-4231-b6b7-375c35069c86,44044248,1327,1254,73,7
407,6b114d4e-8d1c-4231-b6b7-375c35069c86,44044248,1448,1337,111,8
407,6b114d4e-8d1c-4231-b6b7-375c35069c86,44044248,1642,1458,184,9
407,6b114d4e-8d1c-4231-b6b7-375c35069c86,44044248,1913,1644,269,10
407,6b114d4e-8d1c-4231-b6b7-375c35069c86,44044248,2267,1921,346,11
407,6b114d4e-8d1c-4231-b6b7-375c35069c86,44044248,2737,2276,461,12
407,6b114d4e-8d1c-4231-b6b7-375c35069c86,44044248,2890,2746,144,13
407,6b114d4e-8d1c-4231-b6b7-375c35069c86,44044248,3201,2904,297,35
407,6b114d4e-8d1c-4231-b6b7-375c35069c86,44044248,3261,3203,58,36
407,6b114d4e-8d1c-4231-b6b7-375c35069c86,44044248,3370,3265,105,47
407,6b114d4e-8d1c-4231-b6b7-375c35069c86,44044248,4363,3383,980,50
407,6b114d4e-8d1c-4231-b6b7-375c35069c86,44044248,4759,4397,362,51
407,6b114d4e-8d1c-4231-b6b7-375c35069c86,44044248,4889,4761,128,54
407,6b114d4e-8d1c-4231-b6b7-375c35069c86,44044248,4958,4902,56,55
407,6b114d4e-8d1c-4231-b6b7-375c35069c86,44044248,5400,4961,439,60
407,6b114d4e-8d1c-4231-b6b7-375c35069c86,44044248,5389,5333,-56,63
407,6b114d4e-8d1c-4231-b6b7-375c35069c86,44044248,5320,5303,-17,64
407,6b114d4e-8d1c-4231-b6b7-375c35069c86,44044248,5400,5333,-67,65
407,6b114d4e-8d1c-4231-b6b7-375c35069c86,44044248,5265,5039,-226,66
407,6b114d4e-8d1c-4231-b6b7-375c35069c86,44044248,5170,4750,-420,68
407,6b114d4e-8d1c-4231-b6b7-375c35069c86,44044248,4701,4393,-308,70
407,a2ad4028-7803-4df9-a5ad-5164629949e7,44024605,36,5,31,0
407,a2ad4028-7803-4df9-a5ad-5164629949e7,44024605,121,39,82,2
407,a2ad4028-7803-4df9-a5ad-5164629949e7,44024605,198,0,-198,3
407,a2ad4028-7803-4df9-a5ad-5164629949e7,44024605,921,215,706,4
407,a2ad4028-7803-4df9-a5ad-5164629949e7,44024605,936,925,11,5
407,a2ad4028-7803-4df9-a5ad-5164629949e7,44024605,916,604,-312,20
407,a2ad4028-7803-4df9-a5ad-5164629949e7,44024605,600,507,-93,21
407,a2ad4028-7803-4df9-a5ad-5164629949e7,44024605,1042,508,534,22
407,15ac2f06-2b3a-4676-9a98-0c6caf8c8460,44045424,94,22,72,0
407,15ac2f06-2b3a-4676-9a98-0c6caf8c8460,44045424,133,104,29,1
407,15ac2f06-2b3a-4676-9a98-0c6caf8c8460,44045424,247,137,110,2
407,15ac2f06-2b3a-4676-9a98-0c6caf8c8460,44045424,445,255,190,3
407,15ac2f06-2b3a-4676-9a98-0c6caf8c8460,44045424,570,455,115,4
407,15ac2f06-2b3a-4676-9a98-0c6caf8c8460,44045424,675,578,97,5
407,15ac2f06-2b3a-4676-9a98-0c6caf8c8460,44045424,763,683,80,6
407,15ac2f06-2b3a-4676-9a98-0c6caf8c8460,44045424,962,775,187,7
407,15ac2f06-2b3a-4676-9a98-0c6caf8c8460,44045424,1101,971,130,8
407,15ac2f06-2b3a-4676-9a98-0c6caf8c8460,44045424,1216,1106,110,9
407,15ac2f06-2b3a-4676-9a98-0c6caf8c8460,44045424,1315,1220,95,10
407,15ac2f06-2b3a-4676-9a98-0c6caf8c8460,44045424,1481,1324,157,11
407,15ac2f06-2b3a-4676-9a98-0c6caf8c8460,44045424,1501,1485,16,12
407,15ac2f06-2b3a-4676-9a98-0c6caf8c8460,44045424,1550,1507,43,13
407,15ac2f06-2b3a-4676-9a98-0c6caf8c8460,44045424,1598,1556,42,14
407,15ac2f06-2b3a-4676-9a98-0c6caf8c8460,44045424,1640,1605,35,15
407,15ac2f06-2b3a-4676-9a98-0c6caf8c8460,44045424,1713,1641,72,18
407,15ac2f06-2b3a-4676-9a98-0c6caf8c8460,44045424,1802,1724,78,19
407,15ac2f06-2b3a-4676-9a98-0c6caf8c8460,44045424,1837,1804,33,20
407,15ac2f06-2b3a-4676-9a98-0c6caf8c8460,44045424,1947,1847,100,23
407,15ac2f06-2b3a-4676-9a98-0c6caf8c8460,44045424,2020,1948,72,24
407,15ac2f06-2b3a-4676-9a98-0c6caf8c8460,44045424,2101,2027,74,25
407,15ac2f06-2b3a-4676-9a98-0c6caf8c8460,44045424,2160,2103,57,31
407,15ac2f06-2b3a-4676-9a98-0c6caf8c8460,44045424,2290,2166,124,32
407,15ac2f06-2b3a-4676-9a98-0c6caf8c8460,44045424,2338,2297,41,33
407,15ac2f06-2b3a-4676-9a98-0c6caf8c8460,44045424,2442,2341,101,34
407,15ac2f06-2b3a-4676-9a98-0c6caf8c8460,44045424,2486,2452,34,35
407,15ac2f06-2b3a-4676-9a98-0c6caf8c8460,44045424,2639,2488,151,43
407,15ac2f06-2b3a-4676-9a98-0c6caf8c8460,44045424,2949,2647,302,47
407,15ac2f06-2b3a-4676-9a98-0c6caf8c8460,44045424,2846,2471,-375,54
407,15ac2f06-2b3a-4676-9a98-0c6caf8c8460,44045424,2431,1824,-607,55
407,15ac2f06-2b3a-4676-9a98-0c6caf8c8460,44040007,43,0,-43,0
407,15ac2f06-2b3a-4676-9a98-0c6caf8c8460,44040007,190,9,181,83
407,15ac2f06-2b3a-4676-9a98-0c6caf8c8460,44040007,335,200,135,92
407,15ac2f06-2b3a-4676-9a98-0c6caf8c8460,44040007,479,342,137,93
407,15ac2f06-2b3a-4676-9a98-0c6caf8c8460,44040007,677,509,168,94
407,15ac2f06-2b3a-4676-9a98-0c6caf8c8460,44040007,865,691,174,96
407,15ac2f06-2b3a-4676-9a98-0c6caf8c8460,44040007,924,870,54,103
407,15ac2f06-2b3a-4676-9a98-0c6caf8c8460,44040007,966,927,39,128
407,15ac2f06-2b3a-4676-9a98-0c6caf8c8460,44040007,1139,980,159,135
407,15ac2f06-2b3a-4676-9a98-0c6caf8c8460,44040007,1738,1142,596,136
407,15ac2f06-2b3a-4676-9a98-0c6caf8c8460,44040007,1921,1762,159,137
407,15ac2f06-2b3a-4676-9a98-0c6caf8c8460,44040007,2256,1930,326,138
407,15ac2f06-2b3a-4676-9a98-0c6caf8c8460,44040007,2461,2283,178,139
407,15ac2f06-2b3a-4676-9a98-0c6caf8c8460,44040007,2561,2462,99,140
407,15ac2f06-2b3a-4676-9a98-0c6caf8c8460,44040007,2586,2563,23,141
407,15ac2f06-2b3a-4676-9a98-0c6caf8c8460,44040007,3054,2603,451,142
407,15ac2f06-2b3a-4676-9a98-0c6caf8c8460,44040007,3174,3059,115,144
407,15ac2f06-2b3a-4676-9a98-0c6caf8c8460,44038086,177,12,165,0
407,15ac2f06-2b3a-4676-9a98-0c6caf8c8460,44038086,1307,192,1115,1
407,15ac2f06-2b3a-4676-9a98-0c6caf8c8460,44038086,1328,1316,12,2
407,15ac2f06-2b3a-4676-9a98-0c6caf8c8460,44038086,1828,1340,488,3
407,15ac2f06-2b3a-4676-9a98-0c6caf8c8460,44038086,2247,1834,413,4
407,15ac2f06-2b3a-4676-9a98-0c6caf8c8460,44038086,2355,2256,99,5
407,15ac2f06-2b3a-4676-9a98-0c6caf8c8460,44038086,2877,2381,496,9
407,15ac2f06-2b3a-4676-9a98-0c6caf8c8460,44038086,4496,2894,1602,10
407,15ac2f06-2b3a-4676-9a98-0c6caf8c8460,44038086,4582,4498,84,11
407,15ac2f06-2b3a-4676-9a98-0c6caf8c8460,44038086,4667,4585,82,12
407,15ac2f06-2b3a-4676-9a98-0c6caf8c8460,44038086,4706,4670,36,13
407,15ac2f06-2b3a-4676-9a98-0c6caf8c8460,44038086,5515,4709,806,14
407,15ac2f06-2b3a-4676-9a98-0c6caf8c8460,44038086,6477,5552,925,15
407,15ac2f06-2b3a-4676-9a98-0c6caf8c8460,44038086,6796,6513,283,16
407,15ac2f06-2b3a-4676-9a98-0c6caf8c8460,44038086,8317,6720,1597,19
407,15ac2f06-2b3a-4676-9a98-0c6caf8c8460,44038086,8460,8328,132,20
407,15ac2f06-2b3a-4676-9a98-0c6caf8c8460,44038086,8507,8469,38,21
407,15ac2f06-2b3a-4676-9a98-0c6caf8c8460,44038086,8527,8510,17,22
407,15ac2f06-2b3a-4676-9a98-0c6caf8c8460,44038086,8564,8528,36,23
407,15ac2f06-2b3a-4676-9a98-0c6caf8c8460,44038086,8769,8579,190,24
407,15ac2f06-2b3a-4676-9a98-0c6caf8c8460,44038086,9137,8803,334,25
407,15ac2f06-2b3a-4676-9a98-0c6caf8c8460,44038086,9150,9142,8,26
407,15ac2f06-2b3a-4676-9a98-0c6caf8c8460,44038086,10344,9156,1188,27
407,15ac2f06-2b3a-4676-9a98-0c6caf8c8460,44038086,11060,10348,712,28
407,15ac2f06-2b3a-4676-9a98-0c6caf8c8460,44038086,11376,11061,315,31
407,15ac2f06-2b3a-4676-9a98-0c6caf8c8460,44038086,11600,11392,208,32
407,15ac2f06-2b3a-4676-9a98-0c6caf8c8460,44038086,11688,11646,42,33
407,15ac2f06-2b3a-4676-9a98-0c6caf8c8460,44003853,245,2,243,0
407,15ac2f06-2b3a-4676-9a98-0c6caf8c8460,44003853,375,246,129,1
407,15ac2f06-2b3a-4676-9a98-0c6caf8c8460,44003853,461,388,73,2
407,15ac2f06-2b3a-4676-9a98-0c6caf8c8460,44003853,618,471,147,3
407,15ac2f06-2b3a-4676-9a98-0c6caf8c8460,44003853,741,628,113,5
407,15ac2f06-2b3a-4676-9a98-0c6caf8c8460,44003853,873,748,125,6
407,15ac2f06-2b3a-4676-9a98-0c6caf8c8460,44003853,940,882,58,7
407,15ac2f06-2b3a-4676-9a98-0c6caf8c8460,44003853,3128,945,2183,8
407,15ac2f06-2b3a-4676-9a98-0c6caf8c8460,44003853,3678,2741,-937,9
407,15ac2f06-2b3a-4676-9a98-0c6caf8c8460,44003853,2674,1780,-894,10
407,15ac2f06-2b3a-4676-9a98-0c6caf8c8460,44003853,1775,1487,-288,14
407,f403dfd1-218a-4d8e-be95-009f92af8036,44056972,644,15,629,0
407,f403dfd1-218a-4d8e-be95-009f92af8036,44056972,3607,647,2960,1
409,66b37102-f0be-4d71-9f94-e5d9b7f80244,44058190,233,22,211,0
409,66b37102-f0be-4d71-9f94-e5d9b7f80244,44058190,382,238,144,1
409,66b37102-f0be-4d71-9f94-e5d9b7f80244,44058190,463,383,80,3
409,66b37102-f0be-4d71-9f94-e5d9b7f80244,44058190,571,473,98,4
409,66b37102-f0be-4d71-9f94-e5d9b7f80244,44058190,632,582,50,5
409,66b37102-f0be-4d71-9f94-e5d9b7f80244,44058190,765,638,127,7
409,66b37102-f0be-4d71-9f94-e5d9b7f80244,44058190,899,766,133,8
409,66b37102-f0be-4d71-9f94-e5d9b7f80244,44058190,1100,921,179,9
409,66b37102-f0be-4d71-9f94-e5d9b7f80244,44058190,1499,1103,396,10
409,66b37102-f0be-4d71-9f94-e5d9b7f80244,44058190,2685,1522,1163,11
409,66b37102-f0be-4d71-9f94-e5d9b7f80244,44058190,4629,2697,1932,12
409,66b37102-f0be-4d71-9f94-e5d9b7f80244,44058190,6224,4685,1539,13
409,66b37102-f0be-4d71-9f94-e5d9b7f80244,44058190,6218,2855,-3363,24
409,66b37102-f0be-4d71-9f94-e5d9b7f80244,44058190,2853,2851,-2,25
409,66b37102-f0be-4d71-9f94-e5d9b7f80244,44051779,315,1,314,0
409,66b37102-f0be-4d71-9f94-e5d9b7f80244,44051779,437,328,109,1
409,66b37102-f0be-4d71-9f94-e5d9b7f80244,44051779,1881,447,1434,2
409,66b37102-f0be-4d71-9f94-e5d9b7f80244,44051779,3115,1994,1121,3
409,66b37102-f0be-4d71-9f94-e5d9b7f80244,44051779,3503,3275,228,4
409,66b37102-f0be-4d71-9f94-e5d9b7f80244,44051779,3436,3071,-365,5
409,66b37102-f0be-4d71-9f94-e5d9b7f80244,44051779,3253,3073,180,6
409,66b37102-f0be-4d71-9f94-e5d9b7f80244,44051779,3478,3308,170,7
409,66b37102-f0be-4d71-9f94-e5d9b7f80244,44051779,5938,3488,2450,8
409,66b37102-f0be-4d71-9f94-e5d9b7f80244,44051779,5901,5700,-201,9
409,66b37102-f0be-4d71-9f94-e5d9b7f80244,44051779,5654,5554,-100,10
409,66b37102-f0be-4d71-9f94-e5d9b7f80244,44052070,191,19,172,0
409,66b37102-f0be-4d71-9f94-e5d9b7f80244,44052070,502,190,312,1
409,66b37102-f0be-4d71-9f94-e5d9b7f80244,44052070,1908,515,1393,2
409,66b37102-f0be-4d71-9f94-e5d9b7f80244,44052070,2242,1931,311,3
409,66b37102-f0be-4d71-9f94-e5d9b7f80244,44052070,2539,2272,267,4
409,66b37102-f0be-4d71-9f94-e5d9b7f80244,44052070,3294,2575,719,5
409,66b37102-f0be-4d71-9f94-e5d9b7f80244,44052070,5664,3361,2303,6
409,66b37102-f0be-4d71-9f94-e5d9b7f80244,44055362,331,24,307,0
409,66b37102-f0be-4d71-9f94-e5d9b7f80244,44055362,904,0,904,1
409,66b37102-f0be-4d71-9f94-e5d9b7f80244,44055362,990,916,74,2
409,66b37102-f0be-4d71-9f94-e5d9b7f80244,44055362,985,878,-107,4
409,66b37102-f0be-4d71-9f94-e5d9b7f80244,44055362,876,739,-137,5
409,66b37102-f0be-4d71-9f94-e5d9b7f80244,44055362,1232,753,479,7
409,66b37102-f0be-4d71-9f94-e5d9b7f80244,44055362,1477,1243,234,8
409,66b37102-f0be-4d71-9f94-e5d9b7f80244,44055362,1689,1471,218,9
409,66b37102-f0be-4d71-9f94-e5d9b7f80244,44055362,1925,1693,232,10
409,66b37102-f0be-4d71-9f94-e5d9b7f80244,44055362,2100,1936,164,11
409,66b37102-f0be-4d71-9f94-e5d9b7f80244,44055362,2177,2106,71,12
409,66b37102-f0be-4d71-9f94-e5d9b7f80244,44055362,2270,2184,86,13
409,66b37102-f0be-4d71-9f94-e5d9b7f80244,44055362,2404,2281,123,14
409,66b37102-f0be-4d71-9f94-e5d9b7f80244,44055362,2477,2405,72,15
409,66b37102-f0be-4d71-9f94-e5d9b7f80244,44055362,2526,2485,41,16
409,66b37102-f0be-4d71-9f94-e5d9b7f80244,44055362,2591,2529,62,17
409,66b37102-f0be-4d71-9f94-e5d9b7f80244,44055362,2587,2464,-123,18
409,66b37102-f0be-4d71-9f94-e5d9b7f80244,44055362,2520,2469,51,19
409,66b37102-f0be-4d71-9f94-e5d9b7f80244,44055362,2682,2524,158,22
409,66b37102-f0be-4d71-9f94-e5d9b7f80244,44055362,2671,2397,-274,23
409,66b37102-f0be-4d71-9f94-e5d9b7f80244,44055362,2468,2407,61,30
409,66b37102-f0be-4d71-9f94-e5d9b7f80244,44055362,2801,2488,313,31
409,66b37102-f0be-4d71-9f94-e5d9b7f80244,44055362,3052,2818,234,32
409,66b37102-f0be-4d71-9f94-e5d9b7f80244,44055362,3232,3055,177,33
409,66b37102-f0be-4d71-9f94-e5d9b7f80244,44055362,3358,3226,132,34
409,66b37102-f0be-4d71-9f94-e5d9b7f80244,44055362,3628,3372,256,35
409,66b37102-f0be-4d71-9f94-e5d9b7f80244,44055362,3760,3630,130,36
409,66b37102-f0be-4d71-9f94-e5d9b7f80244,44055362,3979,3770,209,37
409,66b37102-f0be-4d71-9f94-e5d9b7f80244,44055362,4044,3989,55,38
409,66b37102-f0be-4d71-9f94-e5d9b7f80244,44055362,4114,4047,67,39
409,66b37102-f0be-4d71-9f94-e5d9b7f80244,44055362,4492,4131,361,40
409,66b37102-f0be-4d71-9f94-e5d9b7f80244,44055362,6772,4519,2253,41
409,66b37102-f0be-4d71-9f94-e5d9b7f80244,44044248,25,1,24,0
409,66b37102-f0be-4d71-9f94-e5d9b7f80244,44044248,28,26,2,1
409,66b37102-f0be-4d71-9f94-e5d9b7f80244,44044248,30,30,0,2
409,66b37102-f0be-4d71-9f94-e5d9b7f80244,44044248,309,32,277,3
409,66b37102-f0be-4d71-9f94-e5d9b7f80244,44044248,519,329,190,4
409,66b37102-f0be-4d71-9f94-e5d9b7f80244,44044248,805,537,268,5
409,66b37102-f0be-4d71-9f94-e5d9b7f80244,44044248,983,822,161,11
409,66b37102-f0be-4d71-9f94-e5d9b7f80244,44044248,1389,1127,262,12
409,66b37102-f0be-4d71-9f94-e5d9b7f80244,44044248,1491,1398,93,13
409,66b37102-f0be-4d71-9f94-e5d9b7f80244,44044248,1757,1499,258,14
409,66b37102-f0be-4d71-9f94-e5d9b7f80244,44044248,2528,1759,769,15
409,66b37102-f0be-4d71-9f94-e5d9b7f80244,44044248,3408,2543,865,16
409,66b37102-f0be-4d71-9f94-e5d9b7f80244,44044248,3763,3417,346,17
409,66b37102-f0be-4d71-9f94-e5d9b7f80244,44044248,5397,3778,1619,18
409,66b37102-f0be-4d71-9f94-e5d9b7f80244,44044248,5469,5411,58,19
409,66b37102-f0be-4d71-9f94-e5d9b7f80244,44044248,5540,5472,68,20
409,66b37102-f0be-4d71-9f94-e5d9b7f80244,44044248,7306,5541,1765,21
409,66b37102-f0be-4d71-9f94-e5d9b7f80244,44044248,8289,7320,969,22
408,f263b22f-c738-4e9b-8cfe-c8b8a7b42b93,44088032,184,4,180,0
408,f263b22f-c738-4e9b-8cfe-c8b8a7b42b93,44088032,466,168,298,1
408,f263b22f-c738-4e9b-8cfe-c8b8a7b42b93,44088032,812,320,-492,2
408,f263b22f-c738-4e9b-8cfe-c8b8a7b42b93,44088032,220,0,-220,3
408,f263b22f-c738-4e9b-8cfe-c8b8a7b42b93,44088032,225,4,221,6
408,f263b22f-c738-4e9b-8cfe-c8b8a7b42b93,44088032,583,232,351,7
408,f263b22f-c738-4e9b-8cfe-c8b8a7b42b93,44088032,1538,601,937,8
408,f263b22f-c738-4e9b-8cfe-c8b8a7b42b93,44088032,3331,1625,1706,9
408,f263b22f-c738-4e9b-8cfe-c8b8a7b42b93,44088032,3683,3350,333,10
408,f263b22f-c738-4e9b-8cfe-c8b8a7b42b93,44088032,3680,3637,-43,13
408,f263b22f-c738-4e9b-8cfe-c8b8a7b42b93,44088032,3635,3596,-39,14
408,f263b22f-c738-4e9b-8cfe-c8b8a7b42b93,44088032,3594,3257,-337,15
408,f263b22f-c738-4e9b-8cfe-c8b8a7b42b93,44088032,3255,3252,-3,16
410,309ffda2-1cce-4c29-9af8-73933a2dd59a,44102158,294,5,289,0
410,309ffda2-1cce-4c29-9af8-73933a2dd59a,44102158,388,302,86,3
410,309ffda2-1cce-4c29-9af8-73933a2dd59a,44102158,540,422,118,4
410,309ffda2-1cce-4c29-9af8-73933a2dd59a,44102158,632,549,83,5
410,309ffda2-1cce-4c29-9af8-73933a2dd59a,44102158,704,643,61,6
410,309ffda2-1cce-4c29-9af8-73933a2dd59a,44102158,717,709,8,7
410,309ffda2-1cce-4c29-9af8-73933a2dd59a,44102158,778,729,49,9
410,309ffda2-1cce-4c29-9af8-73933a2dd59a,44102158,884,785,99,10
410,309ffda2-1cce-4c29-9af8-73933a2dd59a,44102158,968,896,72,11
410,309ffda2-1cce-4c29-9af8-73933a2dd59a,44102158,1045,983,62,12
410,309ffda2-1cce-4c29-9af8-73933a2dd59a,44102158,1159,1057,102,13
410,309ffda2-1cce-4c29-9af8-73933a2dd59a,44102158,1264,1163,101,14
410,309ffda2-1cce-4c29-9af8-73933a2dd59a,44102158,1332,1267,65,16
410,309ffda2-1cce-4c29-9af8-73933a2dd59a,44102158,1390,1335,55,20
410,309ffda2-1cce-4c29-9af8-73933a2dd59a,44102158,1439,1391,48,21
410,309ffda2-1cce-4c29-9af8-73933a2dd59a,44102158,1559,1451,108,23
410,309ffda2-1cce-4c29-9af8-73933a2dd59a,44102158,1617,1591,26,24
410,309ffda2-1cce-4c29-9af8-73933a2dd59a,44102158,1694,1624,70,29
410,309ffda2-1cce-4c29-9af8-73933a2dd59a,44102158,1771,1696,75,40
410,309ffda2-1cce-4c29-9af8-73933a2dd59a,44102158,1835,1780,55,42
410,309ffda2-1cce-4c29-9af8-73933a2dd59a,44102158,1912,1846,66,46
410,309ffda2-1cce-4c29-9af8-73933a2dd59a,44102158,1913,1913,0,47
410,309ffda2-1cce-4c29-9af8-73933a2dd59a,44102158,1970,1915,55,48
410,309ffda2-1cce-4c29-9af8-73933a2dd59a,44102158,2065,1982,83,50
410,309ffda2-1cce-4c29-9af8-73933a2dd59a,44102158,2147,2069,78,53
410,309ffda2-1cce-4c29-9af8-73933a2dd59a,44102158,2180,2149,31,54
410,309ffda2-1cce-4c29-9af8-73933a2dd59a,44102158,2266,2181,85,57
410,309ffda2-1cce-4c29-9af8-73933a2dd59a,44102158,2348,2269,79,58
410,309ffda2-1cce-4c29-9af8-73933a2dd59a,44102158,2414,2356,58,59
410,309ffda2-1cce-4c29-9af8-73933a2dd59a,44102158,2493,2417,76,60
410,309ffda2-1cce-4c29-9af8-73933a2dd59a,44102158,2584,2496,88,63
410,309ffda2-1cce-4c29-9af8-73933a2dd59a,44102158,2658,2593,65,64
410,309ffda2-1cce-4c29-9af8-73933a2dd59a,44102158,2751,2673,78,69
410,309ffda2-1cce-4c29-9af8-73933a2dd59a,44102158,2834,2758,76,74
410,309ffda2-1cce-4c29-9af8-73933a2dd59a,44102158,2920,2849,71,75
410,309ffda2-1cce-4c29-9af8-73933a2dd59a,44102158,3160,2933,227,76
410,309ffda2-1cce-4c29-9af8-73933a2dd59a,44102158,3317,3167,150,77
410,309ffda2-1cce-4c29-9af8-73933a2dd59a,44102158,3444,3330,114,78
410,309ffda2-1cce-4c29-9af8-73933a2dd59a,44102158,3552,3455,97,79
410,309ffda2-1cce-4c29-9af8-73933a2dd59a,44102158,3641,3554,87,80
410,309ffda2-1cce-4c29-9af8-73933a2dd59a,44102158,3719,3646,73,82
410,309ffda2-1cce-4c29-9af8-73933a2dd59a,44102158,3797,3734,63,83
410,309ffda2-1cce-4c29-9af8-73933a2dd59a,44102158,3897,3810,87,87
410,309ffda2-1cce-4c29-9af8-73933a2dd59a,44102158,3964,3901,63,88
410,309ffda2-1cce-4c29-9af8-73933a2dd59a,44102158,4058,3972,86,89
410,309ffda2-1cce-4c29-9af8-73933a2dd59a,44102158,4157,4062,95,91
410,309ffda2-1cce-4c29-9af8-73933a2dd59a,44102158,4302,4162,140,92
410,309ffda2-1cce-4c29-9af8-73933a2dd59a,44102158,4374,4303,71,93
410,309ffda2-1cce-4c29-9af8-73933a2dd59a,44102158,4702,4377,325,94
410,309ffda2-1cce-4c29-9af8-73933a2dd59a,44102158,4805,4719,86,95
410,309ffda2-1cce-4c29-9af8-73933a2dd59a,44102158,4879,4808,71,97
410,309ffda2-1cce-4c29-9af8-73933a2dd59a,44102158,4948,4881,67,98
410,309ffda2-1cce-4c29-9af8-73933a2dd59a,44102158,5004,4950,54,99
410,309ffda2-1cce-4c29-9af8-73933a2dd59a,44102158,5077,5011,66,102
410,309ffda2-1cce-4c29-9af8-73933a2dd59a,44102158,5157,5083,74,103
410,309ffda2-1cce-4c29-9af8-73933a2dd59a,44102158,5162,5162,0,104
410,309ffda2-1cce-4c29-9af8-73933a2dd59a,44102158,5355,5174,181,105
410,309ffda2-1cce-4c29-9af8-73933a2dd59a,44102158,5586,5380,206,106
411,eb74b06d-d481-4ec3-a294-55ed9bfae78d,44089161,466,3,463,0
411,eb74b06d-d481-4ec3-a294-55ed9bfae78d,44089161,482,470,12,1
411,eb74b06d-d481-4ec3-a294-55ed9bfae78d,44089161,594,483,111,7
411,eb74b06d-d481-4ec3-a294-55ed9bfae78d,44089161,834,596,238,8
411,eb74b06d-d481-4ec3-a294-55ed9bfae78d,44089161,1751,865,886,9
411,eb74b06d-d481-4ec3-a294-55ed9bfae78d,44089161,2479,1765,714,13
411,eb74b06d-d481-4ec3-a294-55ed9bfae78d,44089161,3291,2519,772,14
411,eb74b06d-d481-4ec3-a294-55ed9bfae78d,44089161,3316,3296,20,15
411,eb74b06d-d481-4ec3-a294-55ed9bfae78d,44089161,3310,3003,-307,16
411,eb74b06d-d481-4ec3-a294-55ed9bfae78d,44117335,94,10,84,0
411,eb74b06d-d481-4ec3-a294-55ed9bfae78d,44117335,105,95,10,1
411,eb74b06d-d481-4ec3-a294-55ed9bfae78d,44117335,192,118,74,4
411,eb74b06d-d481-4ec3-a294-55ed9bfae78d,44117335,270,204,66,5
411,eb74b06d-d481-4ec3-a294-55ed9bfae78d,44117335,459,284,175,6
411,eb74b06d-d481-4ec3-a294-55ed9bfae78d,44117335,536,464,72,7
411,eb74b06d-d481-4ec3-a294-55ed9bfae78d,44117335,552,537,15,8
411,eb74b06d-d481-4ec3-a294-55ed9bfae78d,44117335,715,560,155,17
411,eb74b06d-d481-4ec3-a294-55ed9bfae78d,44117335,733,720,13,18
411,eb74b06d-d481-4ec3-a294-55ed9bfae78d,44117335,813,736,77,20
411,eb74b06d-d481-4ec3-a294-55ed9bfae78d,44117335,1047,830,217,24
411,eb74b06d-d481-4ec3-a294-55ed9bfae78d,44117335,1266,1064,202,29
411,eb74b06d-d481-4ec3-a294-55ed9bfae78d,44117335,1557,1278,279,30
411,eb74b06d-d481-4ec3-a294-55ed9bfae78d,44117335,1846,1559,287,31
411,eb74b06d-d481-4ec3-a294-55ed9bfae78d,44117335,1919,1850,69,32
411,eb74b06d-d481-4ec3-a294-55ed9bfae78d,44117335,2142,1939,203,33
411,eb74b06d-d481-4ec3-a294-55ed9bfae78d,44117335,2180,2152,28,34
411,eb74b06d-d481-4ec3-a294-55ed9bfae78d,44117335,2345,2190,155,37
411,eb74b06d-d481-4ec3-a294-55ed9bfae78d,44117335,2408,2355,53,38
411,eb74b06d-d481-4ec3-a294-55ed9bfae78d,44117335,2443,2411,32,39
411,eb74b06d-d481-4ec3-a294-55ed9bfae78d,44117335,2483,2451,32,40
411,eb74b06d-d481-4ec3-a294-55ed9bfae78d,44117335,2568,2487,81,41
411,eb74b06d-d481-4ec3-a294-55ed9bfae78d,44117335,2632,2575,57,42
411,eb74b06d-d481-4ec3-a294-55ed9bfae78d,44117335,2686,2639,47,44
411,eb74b06d-d481-4ec3-a294-55ed9bfae78d,44117335,2967,2692,275,45
411,eb74b06d-d481-4ec3-a294-55ed9bfae78d,44117335,3120,2970,150,46
411,eb74b06d-d481-4ec3-a294-55ed9bfae78d,44117335,3187,3124,63,47
411,eb74b06d-d481-4ec3-a294-55ed9bfae78d,44117335,3246,3188,58,48
411,eb74b06d-d481-4ec3-a294-55ed9bfae78d,44117335,3315,3259,56,56
411,eb74b06d-d481-4ec3-a294-55ed9bfae78d,44117335,3400,3319,81,57
411,eb74b06d-d481-4ec3-a294-55ed9bfae78d,44117335,3446,3409,37,58
411,eb74b06d-d481-4ec3-a294-55ed9bfae78d,44117335,4597,3464,1133,64
411,eb74b06d-d481-4ec3-a294-55ed9bfae78d,44117335,5093,4602,491,65
411,eb74b06d-d481-4ec3-a294-55ed9bfae78d,44117335,5210,5115,95,90
411,eb74b06d-d481-4ec3-a294-55ed9bfae78d,44117335,5427,5243,184,93
411,eb74b06d-d481-4ec3-a294-55ed9bfae78d,44081393,115,17,98,0
411,eb74b06d-d481-4ec3-a294-55ed9bfae78d,44081393,157,119,38,1
411,eb74b06d-d481-4ec3-a294-55ed9bfae78d,44081393,251,159,92,2
411,eb74b06d-d481-4ec3-a294-55ed9bfae78d,44081393,511,256,255,3
411,eb74b06d-d481-4ec3-a294-55ed9bfae78d,44081393,663,525,138,4
411,eb74b06d-d481-4ec3-a294-55ed9bfae78d,44081393,799,668,131,5
411,eb74b06d-d481-4ec3-a294-55ed9bfae78d,44081393,934,805,129,6
411,eb74b06d-d481-4ec3-a294-55ed9bfae78d,44081393,1037,935,102,7
411,eb74b06d-d481-4ec3-a294-55ed9bfae78d,44081393,1140,1041,99,8
411,eb74b06d-d481-4ec3-a294-55ed9bfae78d,44081393,1260,1142,118,9
411,eb74b06d-d481-4ec3-a294-55ed9bfae78d,44081393,1301,1262,39,10
411,eb74b06d-d481-4ec3-a294-55ed9bfae78d,44081393,1378,1305,73,11
411,eb74b06d-d481-4ec3-a294-55ed9bfae78d,44081393,1393,1381,12,12
411,eb74b06d-d481-4ec3-a294-55ed9bfae78d,44081393,1500,1400,100,13
411,eb74b06d-d481-4ec3-a294-55ed9bfae78d,44081393,1578,1510,68,14
411,eb74b06d-d481-4ec3-a294-55ed9bfae78d,44081393,1624,1587,37,18
411,eb74b06d-d481-4ec3-a294-55ed9bfae78d,44081393,1691,1636,55,19
411,eb74b06d-d481-4ec3-a294-55ed9bfae78d,44081393,1753,1695,58,20
411,eb74b06d-d481-4ec3-a294-55ed9bfae78d,44081393,1896,1763,133,21
411,eb74b06d-d481-4ec3-a294-55ed9bfae78d,44081393,1949,1897,52,22
411,eb74b06d-d481-4ec3-a294-55ed9bfae78d,44081393,2043,1952,91,23
411,eb74b06d-d481-4ec3-a294-55ed9bfae78d,44081393,2090,2053,37,24
411,eb74b06d-d481-4ec3-a294-55ed9bfae78d,44081393,2163,2095,68,25
411,eb74b06d-d481-4ec3-a294-55ed9bfae78d,44081393,2243,2164,79,26
411,eb74b06d-d481-4ec3-a294-55ed9bfae78d,44081393,2272,2245,27,30
411,eb74b06d-d481-4ec3-a294-55ed9bfae78d,44081393,2310,2281,29,31
411,eb74b06d-d481-4ec3-a294-55ed9bfae78d,44081393,2325,2316,9,32
411,eb74b06d-d481-4ec3-a294-55ed9bfae78d,44081393,2342,2332,10,33
411,eb74b06d-d481-4ec3-a294-55ed9bfae78d,44081393,2353,2346,7,34
411,eb74b06d-d481-4ec3-a294-55ed9bfae78d,44081393,2383,2354,29,35
411,eb74b06d-d481-4ec3-a294-55ed9bfae78d,44081393,2419,2386,33,36
411,eb74b06d-d481-4ec3-a294-55ed9bfae78d,44081393,2491,2430,61,37
411,eb74b06d-d481-4ec3-a294-55ed9bfae78d,44081393,2690,2504,186,38
411,eb74b06d-d481-4ec3-a294-55ed9bfae78d,44081393,2839,2691,148,40
411,eb74b06d-d481-4ec3-a294-55ed9bfae78d,44081393,2889,2840,49,41
411,eb74b06d-d481-4ec3-a294-55ed9bfae78d,44081393,2942,2892,50,47
411,eb74b06d-d481-4ec3-a294-55ed9bfae78d,44081393,2956,2944,12,48
411,eb74b06d-d481-4ec3-a294-55ed9bfae78d,44081393,2983,2957,26,49
411,eb74b06d-d481-4ec3-a294-55ed9bfae78d,44081393,3065,2987,78,52
411,eb74b06d-d481-4ec3-a294-55ed9bfae78d,44081393,3249,3070,179,53
411,eb74b06d-d481-4ec3-a294-55ed9bfae78d,44081393,3314,3255,59,54
411,eb74b06d-d481-4ec3-a294-55ed9bfae78d,44081393,3357,3318,39,55
411,eb74b06d-d481-4ec3-a294-55ed9bfae78d,44081393,3480,3367,113,56
411,eb74b06d-d481-4ec3-a294-55ed9bfae78d,44081393,3576,3488,88,57
411,eb74b06d-d481-4ec3-a294-55ed9bfae78d,44081393,3644,3582,62,58
411,eb74b06d-d481-4ec3-a294-55ed9bfae78d,44081393,3758,3646,112,59
411,eb74b06d-d481-4ec3-a294-55ed9bfae78d,44081393,3776,3762,14,60
411,eb74b06d-d481-4ec3-a294-55ed9bfae78d,44081393,3834,3778,56,64
411,eb74b06d-d481-4ec3-a294-55ed9bfae78d,44081393,3852,3835,17,65
411,eb74b06d-d481-4ec3-a294-55ed9bfae78d,44081393,3950,3856,94,66
411,eb74b06d-d481-4ec3-a294-55ed9bfae78d,44081393,4018,3954,64,67
411,eb74b06d-d481-4ec3-a294-55ed9bfae78d,44081393,4035,4020,15,68
411,eb74b06d-d481-4ec3-a294-55ed9bfae78d,44115166,119,9,110,0
411,eb74b06d-d481-4ec3-a294-55ed9bfae78d,44115166,163,120,43,2
411,eb74b06d-d481-4ec3-a294-55ed9bfae78d,44115166,184,167,17,3
411,eb74b06d-d481-4ec3-a294-55ed9bfae78d,44115166,230,189,41,4
411,eb74b06d-d481-4ec3-a294-55ed9bfae78d,44115166,280,239,41,5
411,eb74b06d-d481-4ec3-a294-55ed9bfae78d,44115166,365,282,83,6
411,eb74b06d-d481-4ec3-a294-55ed9bfae78d,44115166,447,372,75,7
411,eb74b06d-d481-4ec3-a294-55ed9bfae78d,44115166,517,449,68,8
411,eb74b06d-d481-4ec3-a294-55ed9bfae78d,44115166,586,529,57,9
411,eb74b06d-d481-4ec3-a294-55ed9bfae78d,44115166,648,591,57,13
411,eb74b06d-d481-4ec3-a294-55ed9bfae78d,44115166,758,650,108,14
411,eb74b06d-d481-4ec3-a294-55ed9bfae78d,44115166,853,768,85,15
411,eb74b06d-d481-4ec3-a294-55ed9bfae78d,44115166,962,861,101,16
411,eb74b06d-d481-4ec3-a294-55ed9bfae78d,44115166,1259,963,296,17
411,eb74b06d-d481-4ec3-a294-55ed9bfae78d,44115166,1440,1269,171,18
411,eb74b06d-d481-4ec3-a294-55ed9bfae78d,44115166,1644,1458,186,19
411,eb74b06d-d481-4ec3-a294-55ed9bfae78d,44115166,1705,1647,58,20
411,eb74b06d-d481-4ec3-a294-55ed9bfae78d,44115166,1758,1706,52,23
411,eb74b06d-d481-4ec3-a294-55ed9bfae78d,44115166,1775,1761,14,24
411,eb74b06d-d481-4ec3-a294-55ed9bfae78d,44115166,1832,1785,47,25
411,eb74b06d-d481-4ec3-a294-55ed9bfae78d,44115166,2062,1852,210,26
411,eb74b06d-d481-4ec3-a294-55ed9bfae78d,44115166,2695,2065,630,27
411,eb74b06d-d481-4ec3-a294-55ed9bfae78d,44115166,4051,2735,1316,28
411,eb74b06d-d481-4ec3-a294-55ed9bfae78d,44115166,5942,4055,1887,29
411,eb74b06d-d481-4ec3-a294-55ed9bfae78d,44115166,7716,5958,1758,30
411,eb74b06d-d481-4ec3-a294-55ed9bfae78d,44109420,72,8,64,0
410,7f828046-9b3d-4864-b8cf-a74842349374,44116340,439,28,411,0
410,7f828046-9b3d-4864-b8cf-a74842349374,44116340,503,472,31,1
410,7f828046-9b3d-4864-b8cf-a74842349374,44116340,594,516,78,2
410,7f828046-9b3d-4864-b8cf-a74842349374,44116340,1527,624,903,26
410,7f828046-9b3d-4864-b8cf-a74842349374,44116340,1748,1560,188,27
410,7f828046-9b3d-4864-b8cf-a74842349374,44116340,1963,1755,208,28
410,7f828046-9b3d-4864-b8cf-a74842349374,44116340,2240,1988,252,29
410,7f828046-9b3d-4864-b8cf-a74842349374,44116340,3598,2268,1330,30
410,7f828046-9b3d-4864-b8cf-a74842349374,44116340,4197,3622,575,31
411,7d2792b3-b1e5-4099-be2c-df707fb42d0b,44113324,106,13,93,0
411,7d2792b3-b1e5-4099-be2c-df707fb42d0b,44113324,340,110,230,1
411,7d2792b3-b1e5-4099-be2c-df707fb42d0b,44113324,510,348,162,2
411,7d2792b3-b1e5-4099-be2c-df707fb42d0b,44113324,584,514,70,3
411,7d2792b3-b1e5-4099-be2c-df707fb42d0b,44113324,738,592,146,4
411,7d2792b3-b1e5-4099-be2c-df707fb42d0b,44113324,1105,743,362,5
411,7d2792b3-b1e5-4099-be2c-df707fb42d0b,44113324,1158,1115,43,6
411,7d2792b3-b1e5-4099-be2c-df707fb42d0b,44113324,2023,1162,861,25
411,7d2792b3-b1e5-4099-be2c-df707fb42d0b,44113324,2109,2034,75,26
411,7d2792b3-b1e5-4099-be2c-df707fb42d0b,44113324,2738,2121,617,41
411,7d2792b3-b1e5-4099-be2c-df707fb42d0b,44113324,2960,2762,198,42
411,7d2792b3-b1e5-4099-be2c-df707fb42d0b,44113324,3529,2997,532,43
411,7d2792b3-b1e5-4099-be2c-df707fb42d0b,44113324,3621,3540,81,44
411,7d2792b3-b1e5-4099-be2c-df707fb42d0b,44113324,3675,3624,51,45
411,7d2792b3-b1e5-4099-be2c-df707fb42d0b,44113324,3939,3679,260,46
411,7d2792b3-b1e5-4099-be2c-df707fb42d0b,44113324,4265,3940,325,47
411,7d2792b3-b1e5-4099-be2c-df707fb42d0b,44113324,5702,4296,1406,48
411,7d2792b3-b1e5-4099-be2c-df707fb42d0b,44113324,6395,5762,633,49
411,7d2792b3-b1e5-4099-be2c-df707fb42d0b,44124546,246,9,237,0
411,7d2792b3-b1e5-4099-be2c-df707fb42d0b,44124546,273,247,26,1
411,7d2792b3-b1e5-4099-be2c-df707fb42d0b,44124546,335,278,57,2
411,7d2792b3-b1e5-4099-be2c-df707fb42d0b,44124546,402,337,65,3
411,7d2792b3-b1e5-4099-be2c-df707fb42d0b,44124546,1072,425,647,7
411,7d2792b3-b1e5-4099-be2c-df707fb42d0b,44124546,1101,1078,23,8
411,7d2792b3-b1e5-4099-be2c-df707fb42d0b,44124546,1757,1158,599,20
411,7d2792b3-b1e5-4099-be2c-df707fb42d0b,44124546,2435,1783,652,21
411,7d2792b3-b1e5-4099-be2c-df707fb42d0b,44124546,2749,2466,283,22
411,7d2792b3-b1e5-4099-be2c-df707fb42d0b,44134910,663,2,661,0
411,7d2792b3-b1e5-4099-be2c-df707fb42d0b,44134910,670,666,4,1
411,7d2792b3-b1e5-4099-be2c-df707fb42d0b,44134910,1442,688,754,11
411,7d2792b3-b1e5-4099-be2c-df707fb42d0b,44134910,2444,1478,966,12
411,7d2792b3-b1e5-4099-be2c-df707fb42d0b,44134910,3414,2464,950,13
411,7d2792b3-b1e5-4099-be2c-df707fb42d0b,44134910,4144,3430,714,14
411,7d2792b3-b1e5-4099-be2c-df707fb42d0b,44134910,4688,4166,522,15
411,7d2792b3-b1e5-4099-be2c-df707fb42d0b,44134910,5274,4718,556,16
411,7d2792b3-b1e5-4099-be2c-df707fb42d0b,44134910,5684,5276,408,17
411,7d2792b3-b1e5-4099-be2c-df707fb42d0b,44134910,6373,5690,683,18
411,7d2792b3-b1e5-4099-be2c-df707fb42d0b,44134910,7117,6376,741,19
411,7d2792b3-b1e5-4099-be2c-df707fb42d0b,44134910,7298,7130,168,20
411,7d2792b3-b1e5-4099-be2c-df707fb42d0b,44134910,7920,7339,581,21
411,7d2792b3-b1e5-4099-be2c-df707fb42d0b,44134910,7944,7925,19,22
412,0c293e50-dcb7-48b1-98d7-e63b96d51202,44134910,489,42,447,0
412,0c293e50-dcb7-48b1-98d7-e63b96d51202,44134910,560,497,63,1
412,0c293e50-dcb7-48b1-98d7-e63b96d51202,44134910,1187,576,611,9
412,0c293e50-dcb7-48b1-98d7-e63b96d51202,44134910,1191,1190,1,10
412,0c293e50-dcb7-48b1-98d7-e63b96d51202,44134910,1698,1208,490,17
412,0c293e50-dcb7-48b1-98d7-e63b96d51202,44134910,1778,1706,72,18
412,0c293e50-dcb7-48b1-98d7-e63b96d51202,44134910,2256,1784,472,32
412,0c293e50-dcb7-48b1-98d7-e63b96d51202,44134910,2548,2280,268,33
412,0c293e50-dcb7-48b1-98d7-e63b96d51202,44134910,2682,2573,109,34
412,0c293e50-dcb7-48b1-98d7-e63b96d51202,44134910,3532,2700,832,52
412,0c293e50-dcb7-48b1-98d7-e63b96d51202,44134910,3553,3537,16,53
412,0c293e50-dcb7-48b1-98d7-e63b96d51202,44134910,4051,3574,477,77
412,0c293e50-dcb7-48b1-98d7-e63b96d51202,44134910,4468,4116,352,80
412,0c293e50-dcb7-48b1-98d7-e63b96d51202,44134910,4773,4540,233,85
412,0c293e50-dcb7-48b1-98d7-e63b96d51202,44134910,5312,4821,491,86
412,0c293e50-dcb7-48b1-98d7-e63b96d51202,44134910,5824,5331,493,98
412,0c293e50-dcb7-48b1-98d7-e63b96d51202,44134910,6496,5854,642,106
412,0c293e50-dcb7-48b1-98d7-e63b96d51202,44134910,6498,6497,1,107
412,0c293e50-dcb7-48b1-98d7-e63b96d51202,44134910,7156,6535,621,118
412,0c293e50-dcb7-48b1-98d7-e63b96d51202,44134910,7844,7161,683,124
412,0c293e50-dcb7-48b1-98d7-e63b96d51202,44134910,8022,7897,125,125
412,0c293e50-dcb7-48b1-98d7-e63b96d51202,44134910,8415,8100,315,126
412,0c293e50-dcb7-48b1-98d7-e63b96d51202,44109371,84,8,76,0
412,0c293e50-dcb7-48b1-98d7-e63b96d51202,44109371,519,67,452,10
412,0c293e50-dcb7-48b1-98d7-e63b96d51202,44109371,529,521,8,11
412,0c293e50-dcb7-48b1-98d7-e63b96d51202,44109371,627,542,85,13
412,0c293e50-dcb7-48b1-98d7-e63b96d51202,44109371,1022,650,372,14
412,0c293e50-dcb7-48b1-98d7-e63b96d51202,44109371,1443,1039,404,17
412,0c293e50-dcb7-48b1-98d7-e63b96d51202,44109371,1715,1464,251,18
412,0c293e50-dcb7-48b1-98d7-e63b96d51202,44089161,473,30,443,0
412,0c293e50-dcb7-48b1-98d7-e63b96d51202,44089161,546,483,63,1
412,0c293e50-dcb7-48b1-98d7-e63b96d51202,44089161,860,554,306,7
412,0c293e50-dcb7-48b1-98d7-e63b96d51202,44089161,1145,885,260,8
412,0c293e50-dcb7-48b1-98d7-e63b96d51202,44089161,1506,1174,332,13
412,0c293e50-dcb7-48b1-98d7-e63b96d51202,44089161,1658,1536,122,14
412,0c293e50-dcb7-48b1-98d7-e63b96d51202,44089161,2169,1674,495,25
412,0c293e50-dcb7-48b1-98d7-e63b96d51202,44089161,2186,2174,12,26
412,0c293e50-dcb7-48b1-98d7-e63b96d51202,44089161,2822,2226,596,33
412,0c293e50-dcb7-48b1-98d7-e63b96d51202,44089161,2892,2834,58,34
412,0c293e50-dcb7-48b1-98d7-e63b96d51202,44089161,3685,2928,757,43
412,0c293e50-dcb7-48b1-98d7-e63b96d51202,44089161,4281,3688,593,45
412,0c293e50-dcb7-48b1-98d7-e63b96d51202,44089161,4887,4314,573,46
412,0c293e50-dcb7-48b1-98d7-e63b96d51202,44089161,4914,4893,21,47
412,0c293e50-dcb7-48b1-98d7-e63b96d51202,44089161,5317,5032,285,50
412,0c293e50-dcb7-48b1-98d7-e63b96d51202,44089161,6449,5360,1089,51
412,0c293e50-dcb7-48b1-98d7-e63b96d51202,44089161,7655,6456,1199,52
412,0c293e50-dcb7-48b1-98d7-e63b96d51202,44089161,8175,7656,519,53
412,0c293e50-dcb7-48b1-98d7-e63b96d51202,44127611,450,35,415,0
412,0c293e50-dcb7-48b1-98d7-e63b96d51202,44127611,491,463,28,1
412,0c293e50-dcb7-48b1-98d7-e63b96d51202,44127611,1207,543,664,4
412,0c293e50-dcb7-48b1-98d7-e63b96d51202,44127611,1565,1272,293,20
412,0c293e50-dcb7-48b1-98d7-e63b96d51202,44127611,1802,1600,202,21
412,0c293e50-dcb7-48b1-98d7-e63b96d51202,44127611,2367,1803,564,25
412,0c293e50-dcb7-48b1-98d7-e63b96d51202,44127611,2445,2376,69,26
412,0c293e50-dcb7-48b1-98d7-e63b96d51202,44127611,2812,2448,364,33
412,0c293e50-dcb7-48b1-98d7-e63b96d51202,44127611,3076,2841,235,41
412,0c293e50-dcb7-48b1-98d7-e63b96d51202,44127611,3243,3096,147,42
412,0c293e50-dcb7-48b1-98d7-e63b96d51202,44127611,3737,3267,470,46
412,0c293e50-dcb7-48b1-98d7-e63b96d51202,44127611,3738,3738,0,52
410,2957cea6-5c42-4094-8359-60727745f802,44133905,358,6,352,0
410,2957cea6-5c42-4094-8359-60727745f802,44133905,551,359,192,1
410,2957cea6-5c42-4094-8359-60727745f802,44133905,761,562,199,6
410,2957cea6-5c42-4094-8359-60727745f802,44133905,902,771,131,7
410,2957cea6-5c42-4094-8359-60727745f802,44133905,1182,926,256,9
410,2957cea6-5c42-4094-8359-60727745f802,44133905,1268,1190,78,10
410,2957cea6-5c42-4094-8359-60727745f802,44133905,1281,1281,0,21
410,2957cea6-5c42-4094-8359-60727745f802,44133905,1418,1327,91,22
410,2957cea6-5c42-4094-8359-60727745f802,44133905,1455,1430,25,29
410,2957cea6-5c42-4094-8359-60727745f802,44133905,1721,1538,183,30
410,2957cea6-5c42-4094-8359-60727745f802,44133905,1853,1737,116,34
410,2957cea6-5c42-4094-8359-60727745f802,44133905,2046,1856,190,35
410,2957cea6-5c42-4094-8359-60727745f802,44133905,2325,2055,270,41
410,2957cea6-5c42-4094-8359-60727745f802,44133905,2554,2336,218,42
410,2957cea6-5c42-4094-8359-60727745f802,44133905,2668,2556,112,43
410,2957cea6-5c42-4094-8359-60727745f802,44133905,2746,2676,70,50
410,2957cea6-5c42-4094-8359-60727745f802,44133905,2755,2753,2,51
410,2957cea6-5c42-4094-8359-60727745f802,44133905,2965,2770,195,52
410,2957cea6-5c42-4094-8359-60727745f802,44133905,3033,2989,44,53
422,d96a3326-9a4a-4185-9f06-c694ef7057f1,44134910,239,14,225,0
422,d96a3326-9a4a-4185-9f06-c694ef7057f1,44134910,238,0,-238,1
422,d96a3326-9a4a-4185-9f06-c694ef7057f1,44134910,174,0,-174,2
422,d96a3326-9a4a-4185-9f06-c694ef7057f1,44134910,147,0,-147,5
422,d96a3326-9a4a-4185-9f06-c694ef7057f1,44134910,53,6,47,12
422,d96a3326-9a4a-4185-9f06-c694ef7057f1,44134910,433,55,378,13
422,d96a3326-9a4a-4185-9f06-c694ef7057f1,44134910,529,434,95,14
422,d96a3326-9a4a-4185-9f06-c694ef7057f1,44134910,588,531,57,15
422,d96a3326-9a4a-4185-9f06-c694ef7057f1,44134910,665,592,73,16
422,d96a3326-9a4a-4185-9f06-c694ef7057f1,44134910,1106,700,406,30
422,d96a3326-9a4a-4185-9f06-c694ef7057f1,44134910,1168,1111,57,31
422,d96a3326-9a4a-4185-9f06-c694ef7057f1,44134910,1373,1174,199,32
422,d96a3326-9a4a-4185-9f06-c694ef7057f1,44134910,1457,1379,78,33
422,d96a3326-9a4a-4185-9f06-c694ef7057f1,44134910,1511,1462,49,34
422,d96a3326-9a4a-4185-9f06-c694ef7057f1,44134910,1601,1520,81,36
422,d96a3326-9a4a-4185-9f06-c694ef7057f1,44134910,1605,1602,3,37
422,d96a3326-9a4a-4185-9f06-c694ef7057f1,44134910,0,0,0,45
422,d96a3326-9a4a-4185-9f06-c694ef7057f1,44134910,579,8,571,136
422,d96a3326-9a4a-4185-9f06-c694ef7057f1,44134910,1117,598,519,137
422,d96a3326-9a4a-4185-9f06-c694ef7057f1,44134910,1403,1120,283,138
422,d96a3326-9a4a-4185-9f06-c694ef7057f1,44134910,1701,1414,287,139
422,d96a3326-9a4a-4185-9f06-c694ef7057f1,44134910,1751,1514,-237,140
422,d96a3326-9a4a-4185-9f06-c694ef7057f1,44134910,1596,1512,84,141
422,d96a3326-9a4a-4185-9f06-c694ef7057f1,44134910,1940,1618,322,142
422,d96a3326-9a4a-4185-9f06-c694ef7057f1,44134910,2030,1940,90,152
422,d96a3326-9a4a-4185-9f06-c694ef7057f1,44134910,2154,2033,121,153
422,d96a3326-9a4a-4185-9f06-c694ef7057f1,44134910,2255,2156,99,155
422,d96a3326-9a4a-4185-9f06-c694ef7057f1,44134910,2349,2258,91,156
422,d96a3326-9a4a-4185-9f06-c694ef7057f1,44134910,2484,2352,132,157
422,d96a3326-9a4a-4185-9f06-c694ef7057f1,44134910,2583,2485,98,167
422,d96a3326-9a4a-4185-9f06-c694ef7057f1,44134910,2767,2594,173,168
422,d96a3326-9a4a-4185-9f06-c694ef7057f1,44134910,2891,2769,122,169
422,d96a3326-9a4a-4185-9f06-c694ef7057f1,44134910,2950,2900,50,170
422,d96a3326-9a4a-4185-9f06-c694ef7057f1,44134910,3083,2958,125,171
422,d96a3326-9a4a-4185-9f06-c694ef7057f1,44134910,3131,3086,45,172
422,d96a3326-9a4a-4185-9f06-c694ef7057f1,44134910,3165,3132,33,173
422,d96a3326-9a4a-4185-9f06-c694ef7057f1,44134910,3398,3169,229,187
422,d96a3326-9a4a-4185-9f06-c694ef7057f1,44134910,3522,3404,118,188
422,d96a3326-9a4a-4185-9f06-c694ef7057f1,44134910,3587,3529,58,189
422,d96a3326-9a4a-4185-9f06-c694ef7057f1,44134910,3630,3588,42,192
422,d96a3326-9a4a-4185-9f06-c694ef7057f1,44134910,3654,3633,21,193
422,d96a3326-9a4a-4185-9f06-c694ef7057f1,44134910,3737,3655,82,194
422,d96a3326-9a4a-4185-9f06-c694ef7057f1,44134910,3743,3738,5,195
422,d96a3326-9a4a-4185-9f06-c694ef7057f1,44134910,3841,3745,96,198
422,d96a3326-9a4a-4185-9f06-c694ef7057f1,44134910,3946,3847,99,199
422,d96a3326-9a4a-4185-9f06-c694ef7057f1,44134910,3982,3951,31,200
422,d96a3326-9a4a-4185-9f06-c694ef7057f1,44134910,4068,3984,84,203
422,d96a3326-9a4a-4185-9f06-c694ef7057f1,44134910,4163,4070,93,204
422,d96a3326-9a4a-4185-9f06-c694ef7057f1,44134910,4122,4116,-6,205
422,d96a3326-9a4a-4185-9f06-c694ef7057f1,44134910,4270,4119,151,207
422,d96a3326-9a4a-4185-9f06-c694ef7057f1,44134910,4340,4274,66,208
422,d96a3326-9a4a-4185-9f06-c694ef7057f1,44134910,4460,4342,118,214
422,d96a3326-9a4a-4185-9f06-c694ef7057f1,44134910,4597,4462,135,215
422,d96a3326-9a4a-4185-9f06-c694ef7057f1,44134910,4623,4598,25,216
422,d96a3326-9a4a-4185-9f06-c694ef7057f1,44134910,4648,4625,23,217
422,d96a3326-9a4a-4185-9f06-c694ef7057f1,44134910,4870,4665,205,227
422,d96a3326-9a4a-4185-9f06-c694ef7057f1,44134910,4904,4882,22,228
422,d96a3326-9a4a-4185-9f06-c694ef7057f1,44134910,5163,4920,243,229
422,d96a3326-9a4a-4185-9f06-c694ef7057f1,44134910,5259,5170,89,231
422,d96a3326-9a4a-4185-9f06-c694ef7057f1,44134910,5357,5260,97,232
422,d96a3326-9a4a-4185-9f06-c694ef7057f1,44134910,5476,5359,117,233
422,d96a3326-9a4a-4185-9f06-c694ef7057f1,44134910,5668,5480,188,239
422,d96a3326-9a4a-4185-9f06-c694ef7057f1,44134910,5748,5682,66,240
422,d96a3326-9a4a-4185-9f06-c694ef7057f1,44134910,5962,5762,200,247
422,d96a3326-9a4a-4185-9f06-c694ef7057f1,44134910,5998,5963,35,248
422,d96a3326-9a4a-4185-9f06-c694ef7057f1,44134910,6175,6012,163,249
422,d96a3326-9a4a-4185-9f06-c694ef7057f1,44134910,6227,6185,42,250
422,d96a3326-9a4a-4185-9f06-c694ef7057f1,44134910,6444,6236,208,257
422,d96a3326-9a4a-4185-9f06-c694ef7057f1,44134910,6552,6446,106,258
422,d96a3326-9a4a-4185-9f06-c694ef7057f1,44134910,6596,6557,39,259
422,d96a3326-9a4a-4185-9f06-c694ef7057f1,44134910,6694,6601,93,260
422,d96a3326-9a4a-4185-9f06-c694ef7057f1,44134910,6862,6696,166,261
422,d96a3326-9a4a-4185-9f06-c694ef7057f1,44134910,6972,6880,92,268
422,d96a3326-9a4a-4185-9f06-c694ef7057f1,44134910,7012,6974,38,269
422,d96a3326-9a4a-4185-9f06-c694ef7057f1,44134910,7013,7013,0,270
422,d96a3326-9a4a-4185-9f06-c694ef7057f1,44134910,7155,7016,139,271
422,d96a3326-9a4a-4185-9f06-c694ef7057f1,44134910,7210,7157,53,272
422,d96a3326-9a4a-4185-9f06-c694ef7057f1,44141603,430,28,402,0
422,d96a3326-9a4a-4185-9f06-c694ef7057f1,44141603,581,448,133,1
422,d96a3326-9a4a-4185-9f06-c694ef7057f1,44141603,760,590,170,3
422,d96a3326-9a4a-4185-9f06-c694ef7057f1,44141603,897,766,131,4
422,d96a3326-9a4a-4185-9f06-c694ef7057f1,44141603,988,899,89,9
422,d96a3326-9a4a-4185-9f06-c694ef7057f1,44141603,1226,995,231,10
422,d96a3326-9a4a-4185-9f06-c694ef7057f1,44141603,1416,1234,182,11
422,d96a3326-9a4a-4185-9f06-c694ef7057f1,44141603,1429,1417,12,12
422,d96a3326-9a4a-4185-9f06-c694ef7057f1,44141603,1662,1442,220,16
422,d96a3326-9a4a-4185-9f06-c694ef7057f1,44141603,1683,1666,17,17
422,d96a3326-9a4a-4185-9f06-c694ef7057f1,44141603,1730,1693,37,18
422,d96a3326-9a4a-4185-9f06-c694ef7057f1,44141603,1960,1740,220,19
422,d96a3326-9a4a-4185-9f06-c694ef7057f1,44141603,2145,1966,179,21
422,d96a3326-9a4a-4185-9f06-c694ef7057f1,44141603,2154,2146,8,22
422,d96a3326-9a4a-4185-9f06-c694ef7057f1,44141603,2194,2162,32,29
422,d96a3326-9a4a-4185-9f06-c694ef7057f1,44141603,2420,2199,221,30
422,d96a3326-9a4a-4185-9f06-c694ef7057f1,44141603,2562,2422,140,35
422,d96a3326-9a4a-4185-9f06-c694ef7057f1,44136258,82,19,63,0
422,d96a3326-9a4a-4185-9f06-c694ef7057f1,44136258,518,96,422,1
422,d96a3326-9a4a-4185-9f06-c694ef7057f1,44136258,552,521,31,2
422,d96a3326-9a4a-4185-9f06-c694ef7057f1,44136258,681,554,127,3
422,d96a3326-9a4a-4185-9f06-c694ef7057f1,44136258,696,683,13,5
422,d96a3326-9a4a-4185-9f06-c694ef7057f1,44136258,841,701,140,6
422,d96a3326-9a4a-4185-9f06-c694ef7057f1,44136258,929,842,87,7
422,d96a3326-9a4a-4185-9f06-c694ef7057f1,44136258,956,932,24,8
422,d96a3326-9a4a-4185-9f06-c694ef7057f1,44136258,1125,958,167,9
422,d96a3326-9a4a-4185-9f06-c694ef7057f1,44136258,1124,1000,-124,12
422,d96a3326-9a4a-4185-9f06-c694ef7057f1,44136258,991,716,-275,15
422,d96a3326-9a4a-4185-9f06-c694ef7057f1,44136258,882,12,870,28
422,d96a3326-9a4a-4185-9f06-c694ef7057f1,44136258,890,788,-102,29
422,d96a3326-9a4a-4185-9f06-c694ef7057f1,44136258,843,789,54,30
422,d96a3326-9a4a-4185-9f06-c694ef7057f1,44136258,1042,845,197,31
422,d96a3326-9a4a-4185-9f06-c694ef7057f1,44136258,1106,1044,62,32
422,d96a3326-9a4a-4185-9f06-c694ef7057f1,44136258,1177,1108,69,33
422,d96a3326-9a4a-4185-9f06-c694ef7057f1,44136258,1258,1179,79,35
422,d96a3326-9a4a-4185-9f06-c694ef7057f1,44136258,1355,1259,96,36
422,d96a3326-9a4a-4185-9f06-c694ef7057f1,44136258,1417,1357,60,45
422,d96a3326-9a4a-4185-9f06-c694ef7057f1,44136258,1476,1422,54,46
422,d96a3326-9a4a-4185-9f06-c694ef7057f1,44136258,1470,1070,-400,50
422,d96a3326-9a4a-4185-9f06-c694ef7057f1,44136258,1038,730,-308,51
422,d96a3326-9a4a-4185-9f06-c694ef7057f1,44136258,699,490,-209,52
422,d96a3326-9a4a-4185-9f06-c694ef7057f1,44136258,633,429,204,53
422,d96a3326-9a4a-4185-9f06-c694ef7057f1,44136258,960,650,310,54
422,d96a3326-9a4a-4185-9f06-c694ef7057f1,44136258,1256,986,270,55
422,d96a3326-9a4a-4185-9f06-c694ef7057f1,44136258,1394,1257,137,57
422,d96a3326-9a4a-4185-9f06-c694ef7057f1,44136258,1499,1398,101,58
422,d96a3326-9a4a-4185-9f06-c694ef7057f1,44136258,1586,1516,70,60
422,d96a3326-9a4a-4185-9f06-c694ef7057f1,44136258,1764,1593,171,61
422,d96a3326-9a4a-4185-9f06-c694ef7057f1,44136258,1865,1767,98,64
422,d96a3326-9a4a-4185-9f06-c694ef7057f1,44136258,1999,1873,126,65
422,d96a3326-9a4a-4185-9f06-c694ef7057f1,44136258,2157,2001,156,66
422,d96a3326-9a4a-4185-9f06-c694ef7057f1,44136258,2476,2171,305,67
422,d96a3326-9a4a-4185-9f06-c694ef7057f1,44136258,2687,2494,193,74
422,d96a3326-9a4a-4185-9f06-c694ef7057f1,44136258,3056,2723,333,75
422,d96a3326-9a4a-4185-9f06-c694ef7057f1,44136258,3049,2996,-53,76
422,d96a3326-9a4a-4185-9f06-c694ef7057f1,44136258,2995,2995,0,78
422,d96a3326-9a4a-4185-9f06-c694ef7057f1,44136258,3105,2994,111,79
422,d96a3326-9a4a-4185-9f06-c694ef7057f1,44136258,3182,3112,70,80
422,d96a3326-9a4a-4185-9f06-c694ef7057f1,44136258,3285,3186,99,84
422,d96a3326-9a4a-4185-9f06-c694ef7057f1,44136258,3296,3287,9,85
422,d96a3326-9a4a-4185-9f06-c694ef7057f1,44136258,3302,3302,0,86
422,d96a3326-9a4a-4185-9f06-c694ef7057f1,44129386,250,11,239,0
422,d96a3326-9a4a-4185-9f06-c694ef7057f1,44129386,280,253,27,1
422,d96a3326-9a4a-4185-9f06-c694ef7057f1,44129386,514,285,229,2
422,d96a3326-9a4a-4185-9f06-c694ef7057f1,44129386,702,518,184,3
422,d96a3326-9a4a-4185-9f06-c694ef7057f1,44129386,818,706,112,9
422,d96a3326-9a4a-4185-9f06-c694ef7057f1,44129386,1088,832,256,10
422,d96a3326-9a4a-4185-9f06-c694ef7057f1,44129386,1202,1098,104,11
422,d96a3326-9a4a-4185-9f06-c694ef7057f1,44129386,1378,1210,168,12
422,d96a3326-9a4a-4185-9f06-c694ef7057f1,44139459,147,7,140,0
422,d96a3326-9a4a-4185-9f06-c694ef7057f1,44139459,196,148,48,1
422,d96a3326-9a4a-4185-9f06-c694ef7057f1,44139459,349,201,148,2
422,d96a3326-9a4a-4185-9f06-c694ef7057f1,44139459,492,356,136,3
422,d96a3326-9a4a-4185-9f06-c694ef7057f1,44139459,666,494,172,4
422,d96a3326-9a4a-4185-9f06-c694ef7057f1,44139459,793,676,117,5
422,d96a3326-9a4a-4185-9f06-c694ef7057f1,44139459,799,794,5,6
422,d96a3326-9a4a-4185-9f06-c694ef7057f1,44139459,858,801,57,7
422,d96a3326-9a4a-4185-9f06-c694ef7057f1,44139459,1027,861,166,8
422,d96a3326-9a4a-4185-9f06-c694ef7057f1,44139459,1056,1029,27,9
422,d96a3326-9a4a-4185-9f06-c694ef7057f1,44139459,1176,1061,115,10
422,d96a3326-9a4a-4185-9f06-c694ef7057f1,44139459,1331,1180,151,13
422,d96a3326-9a4a-4185-9f06-c694ef7057f1,44139459,1352,1335,17,14
422,d96a3326-9a4a-4185-9f06-c694ef7057f1,44139459,1491,1361,130,18
422,d96a3326-9a4a-4185-9f06-c694ef7057f1,44139459,1508,1495,13,19
422,d96a3326-9a4a-4185-9f06-c694ef7057f1,44139459,1811,1514,297,27
422,d96a3326-9a4a-4185-9f06-c694ef7057f1,44139459,1849,1816,33,28
422,d96a3326-9a4a-4185-9f06-c694ef7057f1,44139459,1933,1850,83,29
422,d96a3326-9a4a-4185-9f06-c694ef7057f1,44139459,1934,1934,0,30
422,d96a3326-9a4a-4185-9f06-c694ef7057f1,44139459,1994,1939,55,33
422,d96a3326-9a4a-4185-9f06-c694ef7057f1,44137354,248,3,245,0
422,d96a3326-9a4a-4185-9f06-c694ef7057f1,44137354,321,249,72,2
422,d96a3326-9a4a-4185-9f06-c694ef7057f1,44137354,590,322,268,7
422,d96a3326-9a4a-4185-9f06-c694ef7057f1,44137354,644,592,52,8
422,d96a3326-9a4a-4185-9f06-c694ef7057f1,44137354,794,649,145,9
422,d96a3326-9a4a-4185-9f06-c694ef7057f1,44137354,1086,808,278,10
422,d96a3326-9a4a-4185-9f06-c694ef7057f1,44137354,1292,1096,196,22
422,d96a3326-9a4a-4185-9f06-c694ef7057f1,44137354,1487,1293,194,23
422,d96a3326-9a4a-4185-9f06-c694ef7057f1,44137354,1560,1491,69,24
422,d96a3326-9a4a-4185-9f06-c694ef7057f1,44137354,1719,1564,155,45
422,d96a3326-9a4a-4185-9f06-c694ef7057f1,44137354,1871,1721,150,46
422,d96a3326-9a4a-4185-9f06-c694ef7057f1,44137354,1968,1875,93,47
422,d96a3326-9a4a-4185-9f06-c694ef7057f1,44137354,2078,1970,108,48
422,d96a3326-9a4a-4185-9f06-c694ef7057f1,44137354,2083,2078,5,49
422,d96a3326-9a4a-4185-9f06-c694ef7057f1,44137354,2198,2084,114,50
422,d96a3326-9a4a-4185-9f06-c694ef7057f1,44137354,2383,2211,172,51
422,d96a3326-9a4a-4185-9f06-c694ef7057f1,44137354,2535,2389,146,52
422,d96a3326-9a4a-4185-9f06-c694ef7057f1,44137354,2577,2539,38,53
422,d96a3326-9a4a-4185-9f06-c694ef7057f1,44137354,2582,2578,4,56
422,d96a3326-9a4a-4185-9f06-c694ef7057f1,44137354,2670,2588,82,58
422,d96a3326-9a4a-4185-9f06-c694ef7057f1,44137354,2809,2675,134,59
422,d96a3326-9a4a-4185-9f06-c694ef7057f1,44137354,2913,2816,97,60
422,d96a3326-9a4a-4185-9f06-c694ef7057f1,44137354,3310,2918,392,65
422,d96a3326-9a4a-4185-9f06-c694ef7057f1,44137354,3514,3314,200,67
422,d96a3326-9a4a-4185-9f06-c694ef7057f1,44137354,3518,3516,2,68
422,d96a3326-9a4a-4185-9f06-c694ef7057f1,44137354,3543,3520,23,69
422,d96a3326-9a4a-4185-9f06-c694ef7057f1,44137354,3728,3547,181,73
422,d96a3326-9a4a-4185-9f06-c694ef7057f1,44137354,3846,3733,113,74
422,d96a3326-9a4a-4185-9f06-c694ef7057f1,44137354,4019,3848,171,77
422,d96a3326-9a4a-4185-9f06-c694ef7057f1,44137354,4202,4023,179,78
422,d96a3326-9a4a-4185-9f06-c694ef7057f1,44137354,4204,4203,1,79
422,d96a3326-9a4a-4185-9f06-c694ef7057f1,44137354,4376,4215,161,80
422,d96a3326-9a4a-4185-9f06-c694ef7057f1,44083625,354,27,327,0
422,d96a3326-9a4a-4185-9f06-c694ef7057f1,44083625,380,360,20,1
422,d96a3326-9a4a-4185-9f06-c694ef7057f1,44083625,499,382,117,2
422,d96a3326-9a4a-4185-9f06-c694ef7057f1,44083625,672,503,169,3
422,d96a3326-9a4a-4185-9f06-c694ef7057f1,44083625,728,680,48,4
422,d96a3326-9a4a-4185-9f06-c694ef7057f1,44083625,902,743,159,8
422,d96a3326-9a4a-4185-9f06-c694ef7057f1,44083625,964,910,54,12
422,d96a3326-9a4a-4185-9f06-c694ef7057f1,44083625,1060,972,88,13
422,d96a3326-9a4a-4185-9f06-c694ef7057f1,44083625,1324,1061,263,15
422,d96a3326-9a4a-4185-9f06-c694ef7057f1,44083625,1488,1332,156,16
422,d96a3326-9a4a-4185-9f06-c694ef7057f1,44083625,1581,1490,91,17
422,d96a3326-9a4a-4185-9f06-c694ef7057f1,44083625,1817,1584,233,18
422,d96a3326-9a4a-4185-9f06-c694ef7057f1,44083625,2023,1823,200,19
422,d96a3326-9a4a-4185-9f06-c694ef7057f1,44083625,2118,2027,91,20
422,d96a3326-9a4a-4185-9f06-c694ef7057f1,44083625,2343,2126,217,21
422,d96a3326-9a4a-4185-9f06-c694ef7057f1,44083625,2498,2350,148,22
422,d96a3326-9a4a-4185-9f06-c694ef7057f1,44083625,2557,2510,47,25
422,d96a3326-9a4a-4185-9f06-c694ef7057f1,44083625,2705,2562,143,26
422,d96a3326-9a4a-4185-9f06-c694ef7057f1,44083625,2781,2708,73,27
422,d96a3326-9a4a-4185-9f06-c694ef7057f1,44083625,2810,2783,27,28
422,d96a3326-9a4a-4185-9f06-c694ef7057f1,44083625,2949,2817,132,29
422,d96a3326-9a4a-4185-9f06-c694ef7057f1,44083625,2982,2904,78,30
422,d96a3326-9a4a-4185-9f06-c694ef7057f1,44083625,3001,2984,17,31
422,d96a3326-9a4a-4185-9f06-c694ef7057f1,44083625,2990,2897,-93,32
422,d96a3326-9a4a-4185-9f06-c694ef7057f1,44083625,2896,2887,-9,33
422,d96a3326-9a4a-4185-9f06-c694ef7057f1,44083625,2906,2879,27,34
422,d96a3326-9a4a-4185-9f06-c694ef7057f1,44083625,3038,2907,131,35
422,d96a3326-9a4a-4185-9f06-c694ef7057f1,44083625,3050,3050,0,41
422,d96a3326-9a4a-4185-9f06-c694ef7057f1,44083625,3281,3061,220,42
422,d96a3326-9a4a-4185-9f06-c694ef7057f1,44083625,3381,3289,92,43
411,9a4d6651-639a-4f9c-b974-6130abd35ab6,44151239,321,26,295,0
411,9a4d6651-639a-4f9c-b974-6130abd35ab6,44151239,369,331,38,1
411,9a4d6651-639a-4f9c-b974-6130abd35ab6,44151239,1264,373,891,2
411,9a4d6651-639a-4f9c-b974-6130abd35ab6,44151239,1332,1302,30,3
412,bdff5baa-1f4b-4ef3-a1e5-9a1d4744fdf1,44143297,604,22,582,0
412,bdff5baa-1f4b-4ef3-a1e5-9a1d4744fdf1,44143297,736,626,110,10
412,bdff5baa-1f4b-4ef3-a1e5-9a1d4744fdf1,44143297,1108,760,348,11
412,bdff5baa-1f4b-4ef3-a1e5-9a1d4744fdf1,44143297,1624,1122,502,21
412,bdff5baa-1f4b-4ef3-a1e5-9a1d4744fdf1,44143297,2270,1625,645,32
412,bdff5baa-1f4b-4ef3-a1e5-9a1d4744fdf1,44143297,2850,2280,570,42
412,bdff5baa-1f4b-4ef3-a1e5-9a1d4744fdf1,44143297,3366,2908,458,52
412,bdff5baa-1f4b-4ef3-a1e5-9a1d4744fdf1,44143297,3355,3352,-3,53
412,bdff5baa-1f4b-4ef3-a1e5-9a1d4744fdf1,44143297,3995,3359,636,65
412,bdff5baa-1f4b-4ef3-a1e5-9a1d4744fdf1,44143297,4386,4000,386,71
412,bdff5baa-1f4b-4ef3-a1e5-9a1d4744fdf1,44143297,4578,4400,178,79
412,bdff5baa-1f4b-4ef3-a1e5-9a1d4744fdf1,44139467,515,27,488,0
412,bdff5baa-1f4b-4ef3-a1e5-9a1d4744fdf1,44139467,1009,558,451,4
412,bdff5baa-1f4b-4ef3-a1e5-9a1d4744fdf1,44139467,1449,1098,351,18
412,bdff5baa-1f4b-4ef3-a1e5-9a1d4744fdf1,44139467,1450,1450,0,19
412,bdff5baa-1f4b-4ef3-a1e5-9a1d4744fdf1,44139467,1820,1496,324,27
412,bdff5baa-1f4b-4ef3-a1e5-9a1d4744fdf1,44139467,2494,1869,625,36
412,bdff5baa-1f4b-4ef3-a1e5-9a1d4744fdf1,44139467,2971,2496,475,44
412,bdff5baa-1f4b-4ef3-a1e5-9a1d4744fdf1,44139467,3296,3012,284,56
412,bdff5baa-1f4b-4ef3-a1e5-9a1d4744fdf1,44139467,3351,3311,40,57
412,bdff5baa-1f4b-4ef3-a1e5-9a1d4744fdf1,44139467,3587,3368,219,62
412,bdff5baa-1f4b-4ef3-a1e5-9a1d4744fdf1,44139467,3618,3600,18,63
412,bdff5baa-1f4b-4ef3-a1e5-9a1d4744fdf1,44124546,541,64,477,0
412,bdff5baa-1f4b-4ef3-a1e5-9a1d4744fdf1,44124546,1206,572,634,12
412,bdff5baa-1f4b-4ef3-a1e5-9a1d4744fdf1,44124546,2002,1246,756,15
412,bdff5baa-1f4b-4ef3-a1e5-9a1d4744fdf1,44124546,2056,2013,43,16
412,bdff5baa-1f4b-4ef3-a1e5-9a1d4744fdf1,44124546,2624,2079,545,22
412,bdff5baa-1f4b-4ef3-a1e5-9a1d4744fdf1,44124546,3040,2686,354,30
412,bdff5baa-1f4b-4ef3-a1e5-9a1d4744fdf1,44124546,3177,3058,119,31
412,bdff5baa-1f4b-4ef3-a1e5-9a1d4744fdf1,44124546,3474,3282,192,36
422,9f63b3e0-83db-45ef-ba03-885d83274bcd,44151239,289,18,271,0
422,9f63b3e0-83db-45ef-ba03-885d83274bcd,44151239,514,305,209,1
422,9f63b3e0-83db-45ef-ba03-885d83274bcd,44151239,584,516,68,2
422,9f63b3e0-83db-45ef-ba03-885d83274bcd,44151239,721,589,132,5
422,9f63b3e0-83db-45ef-ba03-885d83274bcd,44151239,887,728,159,6
422,9f63b3e0-83db-45ef-ba03-885d83274bcd,44151239,1065,888,177,7
422,9f63b3e0-83db-45ef-ba03-885d83274bcd,44151239,1067,607,-460,8
422,9f63b3e0-83db-45ef-ba03-885d83274bcd,44151239,622,609,13,9
422,9f63b3e0-83db-45ef-ba03-885d83274bcd,44151239,624,623,1,10
422,9f63b3e0-83db-45ef-ba03-885d83274bcd,44151239,621,611,-10,11
422,9f63b3e0-83db-45ef-ba03-885d83274bcd,44151239,653,616,37,19
422,9f63b3e0-83db-45ef-ba03-885d83274bcd,44151239,1020,672,348,20
422,9f63b3e0-83db-45ef-ba03-885d83274bcd,44151239,1244,1025,219,21
422,9f63b3e0-83db-45ef-ba03-885d83274bcd,44151239,1539,1249,290,22
422,9f63b3e0-83db-45ef-ba03-885d83274bcd,44151239,1627,1544,83,23
422,9f63b3e0-83db-45ef-ba03-885d83274bcd,44151239,1717,1647,70,34
422,9f63b3e0-83db-45ef-ba03-885d83274bcd,44151239,2041,1722,319,35
422,9f63b3e0-83db-45ef-ba03-885d83274bcd,44151239,2000,1840,-160,36
422,9f63b3e0-83db-45ef-ba03-885d83274bcd,44151239,2166,1900,266,37
422,9f63b3e0-83db-45ef-ba03-885d83274bcd,44151239,2344,2166,178,38
422,9f63b3e0-83db-45ef-ba03-885d83274bcd,44151239,2347,2297,-50,39
422,9f63b3e0-83db-45ef-ba03-885d83274bcd,44151239,2315,2301,14,40
422,9f63b3e0-83db-45ef-ba03-885d83274bcd,44151239,2304,1493,-811,42
422,9f63b3e0-83db-45ef-ba03-885d83274bcd,44151239,1671,1490,181,43
422,9f63b3e0-83db-45ef-ba03-885d83274bcd,44151239,1670,1564,-106,44
422,9f63b3e0-83db-45ef-ba03-885d83274bcd,44151239,2196,1565,631,45
422,9f63b3e0-83db-45ef-ba03-885d83274bcd,44151239,2207,2198,9,46
422,9f63b3e0-83db-45ef-ba03-885d83274bcd,44151239,2409,2210,199,50
422,9f63b3e0-83db-45ef-ba03-885d83274bcd,44151239,2457,2411,46,51
422,9f63b3e0-83db-45ef-ba03-885d83274bcd,44151239,2685,2464,221,53
422,9f63b3e0-83db-45ef-ba03-885d83274bcd,44151239,2663,2576,-87,54
422,9f63b3e0-83db-45ef-ba03-885d83274bcd,44151239,2748,2580,168,55
422,9f63b3e0-83db-45ef-ba03-885d83274bcd,44151239,2824,2758,66,56
422,9f63b3e0-83db-45ef-ba03-885d83274bcd,44151239,3213,2833,380,69
422,9f63b3e0-83db-45ef-ba03-885d83274bcd,44151239,3408,3221,187,72
422,9f63b3e0-83db-45ef-ba03-885d83274bcd,44151239,3608,3413,195,73
422,9f63b3e0-83db-45ef-ba03-885d83274bcd,44151239,3768,3616,152,74
422,9f63b3e0-83db-45ef-ba03-885d83274bcd,44151239,3778,3770,8,75
422,9f63b3e0-83db-45ef-ba03-885d83274bcd,44148285,388,5,383,0
422,9f63b3e0-83db-45ef-ba03-885d83274bcd,44148285,540,398,142,1
422,9f63b3e0-83db-45ef-ba03-885d83274bcd,44148285,637,543,94,2
422,9f63b3e0-83db-45ef-ba03-885d83274bcd,44148285,714,638,76,9
422,9f63b3e0-83db-45ef-ba03-885d83274bcd,44148285,828,715,113,10
422,9f63b3e0-83db-45ef-ba03-885d83274bcd,44148285,885,829,56,11
422,9f63b3e0-83db-45ef-ba03-885d83274bcd,44148285,988,887,101,12
422,9f63b3e0-83db-45ef-ba03-885d83274bcd,44148285,1043,989,54,13
422,9f63b3e0-83db-45ef-ba03-885d83274bcd,44148285,1049,1045,4,14
422,9f63b3e0-83db-45ef-ba03-885d83274bcd,44148285,1207,1054,153,15
422,9f63b3e0-83db-45ef-ba03-885d83274bcd,44148285,1209,1209,0,16
422,9f63b3e0-83db-45ef-ba03-885d83274bcd,44148285,1228,1213,15,18
422,9f63b3e0-83db-45ef-ba03-885d83274bcd,44148285,1421,1234,187,19
422,9f63b3e0-83db-45ef-ba03-885d83274bcd,44148285,1478,1423,55,20
422,9f63b3e0-83db-45ef-ba03-885d83274bcd,44148285,1715,1487,228,21
422,9f63b3e0-83db-45ef-ba03-885d83274bcd,44148285,1817,1721,96,22
422,9f63b3e0-83db-45ef-ba03-885d83274bcd,44148285,1822,1818,4,23
422,9f63b3e0-83db-45ef-ba03-885d83274bcd,44148285,2100,1829,271,25
422,9f63b3e0-83db-45ef-ba03-885d83274bcd,44148285,2291,2113,178,31
422,9f63b3e0-83db-45ef-ba03-885d83274bcd,44148285,2707,2301,406,40
422,9f63b3e0-83db-45ef-ba03-885d83274bcd,44148285,2984,2729,255,45
422,9f63b3e0-83db-45ef-ba03-885d83274bcd,44148285,3185,3006,179,46
422,9f63b3e0-83db-45ef-ba03-885d83274bcd,44151302,48,11,37,0
424,f1cf662b-1fce-4de0-8ec8-b544b6d34df1,44129714,186,3,183,0
424,f1cf662b-1fce-4de0-8ec8-b544b6d34df1,44129714,241,0,-241,1
424,f1cf662b-1fce-4de0-8ec8-b544b6d34df1,44129714,161,1,160,2
424,f1cf662b-1fce-4de0-8ec8-b544b6d34df1,44129714,320,162,158,3
424,f1cf662b-1fce-4de0-8ec8-b544b6d34df1,44129714,581,336,245,4
424,f1cf662b-1fce-4de0-8ec8-b544b6d34df1,44129714,677,583,94,5
424,f1cf662b-1fce-4de0-8ec8-b544b6d34df1,44129714,852,680,172,6
424,f1cf662b-1fce-4de0-8ec8-b544b6d34df1,44129714,782,637,-145,47
424,f1cf662b-1fce-4de0-8ec8-b544b6d34df1,44129714,557,0,-557,48
424,f1cf662b-1fce-4de0-8ec8-b544b6d34df1,44129714,1371,4,1367,61
424,f1cf662b-1fce-4de0-8ec8-b544b6d34df1,44129714,1487,1219,-268,62
424,f1cf662b-1fce-4de0-8ec8-b544b6d34df1,44129714,1208,901,-307,70
424,f1cf662b-1fce-4de0-8ec8-b544b6d34df1,44129714,900,886,-14,71
424,f1cf662b-1fce-4de0-8ec8-b544b6d34df1,44129714,1089,889,200,72
424,f1cf662b-1fce-4de0-8ec8-b544b6d34df1,44129714,1242,1101,141,97
424,f1cf662b-1fce-4de0-8ec8-b544b6d34df1,44129714,1361,1246,115,142
424,f1cf662b-1fce-4de0-8ec8-b544b6d34df1,44129714,1716,1371,345,144
424,f1cf662b-1fce-4de0-8ec8-b544b6d34df1,44129714,1851,1739,112,145
424,f1cf662b-1fce-4de0-8ec8-b544b6d34df1,44129714,1953,1859,94,146
424,f1cf662b-1fce-4de0-8ec8-b544b6d34df1,44129714,2056,1956,100,157
424,f1cf662b-1fce-4de0-8ec8-b544b6d34df1,44129714,2062,2057,5,158
424,f1cf662b-1fce-4de0-8ec8-b544b6d34df1,44129714,2656,2088,568,190
424,f1cf662b-1fce-4de0-8ec8-b544b6d34df1,44129714,2725,2667,58,191
424,f1cf662b-1fce-4de0-8ec8-b544b6d34df1,44129714,3073,2732,341,204
424,f1cf662b-1fce-4de0-8ec8-b544b6d34df1,44129714,3458,3075,383,206
424,f1cf662b-1fce-4de0-8ec8-b544b6d34df1,44129714,3825,3498,327,207
424,f1cf662b-1fce-4de0-8ec8-b544b6d34df1,44129714,4138,3827,311,216
424,f1cf662b-1fce-4de0-8ec8-b544b6d34df1,44129714,4355,4140,215,217
424,f1cf662b-1fce-4de0-8ec8-b544b6d34df1,44129714,4571,4370,201,223
424,f1cf662b-1fce-4de0-8ec8-b544b6d34df1,44129714,4609,4572,37,224
424,f1cf662b-1fce-4de0-8ec8-b544b6d34df1,44129714,5252,4618,634,233
424,f1cf662b-1fce-4de0-8ec8-b544b6d34df1,44129714,6159,5300,859,234
424,f1cf662b-1fce-4de0-8ec8-b544b6d34df1,44129714,7683,6259,1424,235
424,c9f62cc7-3786-45fb-9c53-b16d84053259,44154398,201,0,-201,0
424,c9f62cc7-3786-45fb-9c53-b16d84053259,44154398,504,18,486,1
424,c9f62cc7-3786-45fb-9c53-b16d84053259,44154398,673,525,148,2
424,c9f62cc7-3786-45fb-9c53-b16d84053259,44154398,808,675,133,3
424,c9f62cc7-3786-45fb-9c53-b16d84053259,44154398,896,819,77,5
424,c9f62cc7-3786-45fb-9c53-b16d84053259,44154398,989,901,88,6
424,c9f62cc7-3786-45fb-9c53-b16d84053259,44154398,1001,292,-709,7
424,c9f62cc7-3786-45fb-9c53-b16d84053259,44154398,355,269,86,8
424,c9f62cc7-3786-45fb-9c53-b16d84053259,44154398,540,354,186,9
424,c9f62cc7-3786-45fb-9c53-b16d84053259,44154398,617,557,60,10
424,c9f62cc7-3786-45fb-9c53-b16d84053259,44154398,726,629,97,11
424,c9f62cc7-3786-45fb-9c53-b16d84053259,44154398,939,733,206,12
424,c9f62cc7-3786-45fb-9c53-b16d84053259,44154398,1008,943,65,13
424,c9f62cc7-3786-45fb-9c53-b16d84053259,44154398,1308,1012,296,18
424,c9f62cc7-3786-45fb-9c53-b16d84053259,44154398,1363,1312,51,21
424,c9f62cc7-3786-45fb-9c53-b16d84053259,44154398,1454,1364,90,22
424,c9f62cc7-3786-45fb-9c53-b16d84053259,44154398,1734,1463,271,24
424,c9f62cc7-3786-45fb-9c53-b16d84053259,44154398,1966,1738,228,61
424,c9f62cc7-3786-45fb-9c53-b16d84053259,44154398,2168,1968,200,62
424,c9f62cc7-3786-45fb-9c53-b16d84053259,44154398,2245,2181,64,63
424,c9f62cc7-3786-45fb-9c53-b16d84053259,44154398,2268,2246,22,64
424,c9f62cc7-3786-45fb-9c53-b16d84053259,44140844,202,6,196,0
424,c9f62cc7-3786-45fb-9c53-b16d84053259,44140844,371,201,170,1
424,c9f62cc7-3786-45fb-9c53-b16d84053259,44140844,624,376,248,2
424,c9f62cc7-3786-45fb-9c53-b16d84053259,44140844,723,633,90,3
424,c9f62cc7-3786-45fb-9c53-b16d84053259,44140844,896,728,168,18
424,c9f62cc7-3786-45fb-9c53-b16d84053259,44140844,1164,914,250,19
424,c9f62cc7-3786-45fb-9c53-b16d84053259,44140844,1617,1218,399,40
424,c9f62cc7-3786-45fb-9c53-b16d84053259,44140844,0,0,0,59
424,c9f62cc7-3786-45fb-9c53-b16d84053259,44140844,94,15,79,66
424,c9f62cc7-3786-45fb-9c53-b16d84053259,44140844,216,97,119,67
424,c9f62cc7-3786-45fb-9c53-b16d84053259,44140844,254,217,37,68
424,c9f62cc7-3786-45fb-9c53-b16d84053259,44140844,276,258,18,70
424,c9f62cc7-3786-45fb-9c53-b16d84053259,44140844,369,282,87,71
424,c9f62cc7-3786-45fb-9c53-b16d84053259,44140844,461,370,91,72
424,c9f62cc7-3786-45fb-9c53-b16d84053259,44140844,798,481,317,74
424,c9f62cc7-3786-45fb-9c53-b16d84053259,44140844,2015,805,1210,75
424,c9f62cc7-3786-45fb-9c53-b16d84053259,44140844,2175,2029,146,76
424,c9f62cc7-3786-45fb-9c53-b16d84053259,44140844,2312,2180,132,77
424,c9f62cc7-3786-45fb-9c53-b16d84053259,44140844,2580,2319,261,109
424,c9f62cc7-3786-45fb-9c53-b16d84053259,44140844,2636,2582,54,110
424,c9f62cc7-3786-45fb-9c53-b16d84053259,44140844,2875,2637,238,145
424,c9f62cc7-3786-45fb-9c53-b16d84053259,44140844,3040,2888,152,146
424,c9f62cc7-3786-45fb-9c53-b16d84053259,44140844,3275,3261,14,758
424,c9f62cc7-3786-45fb-9c53-b16d84053259,44140844,3256,2804,-452,759
424,c9f62cc7-3786-45fb-9c53-b16d84053259,44140844,2792,2581,-211,762
424,c9f62cc7-3786-45fb-9c53-b16d84053259,44140844,2572,2394,-178,763
424,c9f62cc7-3786-45fb-9c53-b16d84053259,44140844,2585,2495,90,764
424,c9f62cc7-3786-45fb-9c53-b16d84053259,44140844,2728,2589,139,765
424,c9f62cc7-3786-45fb-9c53-b16d84053259,44140844,2830,2733,97,766
424,c9f62cc7-3786-45fb-9c53-b16d84053259,44140844,2833,2831,2,767
424,c9f62cc7-3786-45fb-9c53-b16d84053259,44140844,2918,2835,83,773
424,c9f62cc7-3786-45fb-9c53-b16d84053259,44140844,3077,2931,146,774
424,c9f62cc7-3786-45fb-9c53-b16d84053259,44140844,3098,3081,17,775
424,c9f62cc7-3786-45fb-9c53-b16d84053259,44140844,3225,3114,111,776
424,c9f62cc7-3786-45fb-9c53-b16d84053259,44140844,3513,3234,279,778
424,c9f62cc7-3786-45fb-9c53-b16d84053259,44140844,3612,3522,90,780
424,c9f62cc7-3786-45fb-9c53-b16d84053259,44140844,3641,3621,20,782
424,c9f62cc7-3786-45fb-9c53-b16d84053259,44140844,3699,3647,52,783
424,c9f62cc7-3786-45fb-9c53-b16d84053259,44140844,3704,3704,0,791
424,c9f62cc7-3786-45fb-9c53-b16d84053259,44140844,3853,3717,136,792
424,c9f62cc7-3786-45fb-9c53-b16d84053259,44140844,4118,3879,239,793
424,c9f62cc7-3786-45fb-9c53-b16d84053259,44140844,4212,4129,83,794
424,c9f62cc7-3786-45fb-9c53-b16d84053259,44140844,4318,4223,95,829
424,c9f62cc7-3786-45fb-9c53-b16d84053259,44140844,4758,4338,420,830
424,c9f62cc7-3786-45fb-9c53-b16d84053259,44140844,4783,4764,19,831
424,c9f62cc7-3786-45fb-9c53-b16d84053259,44140844,5034,4831,203,870
424,c9f62cc7-3786-45fb-9c53-b16d84053259,44140844,5175,5054,121,871
424,c9f62cc7-3786-45fb-9c53-b16d84053259,44140844,5174,5174,0,872
424,c9f62cc7-3786-45fb-9c53-b16d84053259,44140844,5857,5216,641,873
424,c9f62cc7-3786-45fb-9c53-b16d84053259,44140844,5873,5861,12,874
424,c9f62cc7-3786-45fb-9c53-b16d84053259,44140844,5929,5875,54,875
424,c9f62cc7-3786-45fb-9c53-b16d84053259,44140844,6031,5936,95,876
424,c9f62cc7-3786-45fb-9c53-b16d84053259,44140844,6505,6055,450,878
424,c9f62cc7-3786-45fb-9c53-b16d84053259,44140844,6958,6540,418,879
424,c9f62cc7-3786-45fb-9c53-b16d84053259,44140844,8240,6991,1249,880
424,c9f62cc7-3786-45fb-9c53-b16d84053259,44140844,8255,8244,11,881
423,30d21da7-b4b6-49d1-a82e-01f3564ba99d,44158566,131,16,115,0
423,30d21da7-b4b6-49d1-a82e-01f3564ba99d,44158566,403,154,249,1
423,30d21da7-b4b6-49d1-a82e-01f3564ba99d,44158566,638,416,222,6
423,30d21da7-b4b6-49d1-a82e-01f3564ba99d,44158566,847,657,190,11
423,30d21da7-b4b6-49d1-a82e-01f3564ba99d,44158566,1041,848,193,15
423,30d21da7-b4b6-49d1-a82e-01f3564ba99d,44158566,1156,1049,107,24
423,30d21da7-b4b6-49d1-a82e-01f3564ba99d,44158566,1236,1165,71,25
423,30d21da7-b4b6-49d1-a82e-01f3564ba99d,44158566,1553,1261,292,28
423,30d21da7-b4b6-49d1-a82e-01f3564ba99d,44158566,1736,1577,159,29
423,30d21da7-b4b6-49d1-a82e-01f3564ba99d,44158566,1886,1742,144,38
423,30d21da7-b4b6-49d1-a82e-01f3564ba99d,44158566,1921,1900,21,39
423,30d21da7-b4b6-49d1-a82e-01f3564ba99d,44158566,1995,1925,70,42
423,30d21da7-b4b6-49d1-a82e-01f3564ba99d,44158566,1955,1798,-157,45
423,30d21da7-b4b6-49d1-a82e-01f3564ba99d,44158566,1972,1818,154,46
423,30d21da7-b4b6-49d1-a82e-01f3564ba99d,44158566,2141,1981,160,53
423,30d21da7-b4b6-49d1-a82e-01f3564ba99d,44158566,2142,2136,-6,54
423,30d21da7-b4b6-49d1-a82e-01f3564ba99d,44158566,2319,2141,178,66
423,30d21da7-b4b6-49d1-a82e-01f3564ba99d,44158566,2450,2343,107,68
423,30d21da7-b4b6-49d1-a82e-01f3564ba99d,44158566,2459,2456,3,69
423,30d21da7-b4b6-49d1-a82e-01f3564ba99d,44158566,2643,2462,181,76
423,30d21da7-b4b6-49d1-a82e-01f3564ba99d,44158566,2708,2652,56,77
423,30d21da7-b4b6-49d1-a82e-01f3564ba99d,44158566,2745,2725,20,78
423,30d21da7-b4b6-49d1-a82e-01f3564ba99d,44158566,2960,2754,206,80
423,30d21da7-b4b6-49d1-a82e-01f3564ba99d,44158566,3028,2961,67,81
423,30d21da7-b4b6-49d1-a82e-01f3564ba99d,44158566,3042,3031,11,88
423,30d21da7-b4b6-49d1-a82e-01f3564ba99d,44158566,3258,3052,206,89
423,30d21da7-b4b6-49d1-a82e-01f3564ba99d,44158566,3535,3276,259,100
423,30d21da7-b4b6-49d1-a82e-01f3564ba99d,44158566,3684,3541,143,108
423,30d21da7-b4b6-49d1-a82e-01f3564ba99d,44158566,3853,3697,156,109
423,30d21da7-b4b6-49d1-a82e-01f3564ba99d,44158566,3982,3855,127,119
423,30d21da7-b4b6-49d1-a82e-01f3564ba99d,44158566,4144,3999,145,120
423,30d21da7-b4b6-49d1-a82e-01f3564ba99d,44158566,4320,4162,158,121
423,30d21da7-b4b6-49d1-a82e-01f3564ba99d,44158566,4324,4321,-3,122
423,30d21da7-b4b6-49d1-a82e-01f3564ba99d,44158566,4394,4332,62,125
423,30d21da7-b4b6-49d1-a82e-01f3564ba99d,44158566,4580,4400,180,131
423,30d21da7-b4b6-49d1-a82e-01f3564ba99d,44158566,4749,4584,165,134
423,30d21da7-b4b6-49d1-a82e-01f3564ba99d,44158566,4827,4756,71,137
423,30d21da7-b4b6-49d1-a82e-01f3564ba99d,44148027,112,9,103,0
423,30d21da7-b4b6-49d1-a82e-01f3564ba99d,44148027,169,128,41,1
423,30d21da7-b4b6-49d1-a82e-01f3564ba99d,44148027,147,0,-147,2
423,30d21da7-b4b6-49d1-a82e-01f3564ba99d,44148027,105,4,101,3
423,30d21da7-b4b6-49d1-a82e-01f3564ba99d,44148027,254,117,137,4
423,30d21da7-b4b6-49d1-a82e-01f3564ba99d,44148027,496,261,235,12
423,30d21da7-b4b6-49d1-a82e-01f3564ba99d,44148027,630,499,131,13
423,30d21da7-b4b6-49d1-a82e-01f3564ba99d,44148027,859,670,189,14
423,30d21da7-b4b6-49d1-a82e-01f3564ba99d,44148027,985,874,111,15
423,30d21da7-b4b6-49d1-a82e-01f3564ba99d,44148027,1045,995,50,23
423,30d21da7-b4b6-49d1-a82e-01f3564ba99d,44148027,1129,1060,69,24
423,30d21da7-b4b6-49d1-a82e-01f3564ba99d,44148027,1347,1140,207,25
423,30d21da7-b4b6-49d1-a82e-01f3564ba99d,44148027,1519,1354,165,31
423,30d21da7-b4b6-49d1-a82e-01f3564ba99d,44148027,1618,1521,97,32
423,30d21da7-b4b6-49d1-a82e-01f3564ba99d,44148027,1729,1634,95,33
423,30d21da7-b4b6-49d1-a82e-01f3564ba99d,44148027,1880,1739,141,35
423,30d21da7-b4b6-49d1-a82e-01f3564ba99d,44148027,2027,1888,139,37
423,30d21da7-b4b6-49d1-a82e-01f3564ba99d,44148027,2162,2032,130,47
423,30d21da7-b4b6-49d1-a82e-01f3564ba99d,44148027,2479,2163,316,51
423,30d21da7-b4b6-49d1-a82e-01f3564ba99d,44148027,2621,2484,137,52
423,30d21da7-b4b6-49d1-a82e-01f3564ba99d,44148027,2866,2632,234,54
423,30d21da7-b4b6-49d1-a82e-01f3564ba99d,44148027,2936,2867,69,55
423,30d21da7-b4b6-49d1-a82e-01f3564ba99d,44148027,3033,2942,91,58
423,30d21da7-b4b6-49d1-a82e-01f3564ba99d,44148027,3089,3044,45,59
423,30d21da7-b4b6-49d1-a82e-01f3564ba99d,44148027,3312,3102,210,63
423,30d21da7-b4b6-49d1-a82e-01f3564ba99d,44148027,3315,3314,1,64
423,30d21da7-b4b6-49d1-a82e-01f3564ba99d,44148027,3390,3321,69,66
423,30d21da7-b4b6-49d1-a82e-01f3564ba99d,44148027,3487,3398,89,67
423,30d21da7-b4b6-49d1-a82e-01f3564ba99d,44148027,3608,3493,115,69
423,30d21da7-b4b6-49d1-a82e-01f3564ba99d,44148027,3689,3611,78,70
423,30d21da7-b4b6-49d1-a82e-01f3564ba99d,44148027,3693,3690,3,71
423,30d21da7-b4b6-49d1-a82e-01f3564ba99d,44148027,4010,3706,304,95
423,30d21da7-b4b6-49d1-a82e-01f3564ba99d,44148027,4278,4047,231,96
423,30d21da7-b4b6-49d1-a82e-01f3564ba99d,44148027,4419,4283,136,98
423,30d21da7-b4b6-49d1-a82e-01f3564ba99d,44148027,4723,4423,300,99
423,30d21da7-b4b6-49d1-a82e-01f3564ba99d,44148027,4724,4724,0,100
423,30d21da7-b4b6-49d1-a82e-01f3564ba99d,44148027,5111,4731,380,102
423,30d21da7-b4b6-49d1-a82e-01f3564ba99d,44148027,5211,5148,63,103
411,642b557c-a5c2-4aa9-b90a-92f18c688606,44163575,76,3,73,0
411,642b557c-a5c2-4aa9-b90a-92f18c688606,44163575,492,91,401,1
411,642b557c-a5c2-4aa9-b90a-92f18c688606,44163575,666,496,170,2
411,642b557c-a5c2-4aa9-b90a-92f18c688606,44163575,901,670,231,3
411,642b557c-a5c2-4aa9-b90a-92f18c688606,44163575,960,902,58,15
411,642b557c-a5c2-4aa9-b90a-92f18c688606,44163575,1154,971,183,25
411,642b557c-a5c2-4aa9-b90a-92f18c688606,44163575,1209,1159,50,26
411,642b557c-a5c2-4aa9-b90a-92f18c688606,44163575,1428,1211,217,28
411,642b557c-a5c2-4aa9-b90a-92f18c688606,44163575,1435,1432,3,29
411,642b557c-a5c2-4aa9-b90a-92f18c688606,44163575,1508,1444,64,33
411,642b557c-a5c2-4aa9-b90a-92f18c688606,44163575,1761,1510,251,35
411,642b557c-a5c2-4aa9-b90a-92f18c688606,44163575,2139,1763,376,36
411,642b557c-a5c2-4aa9-b90a-92f18c688606,44163575,2652,2148,504,37
411,642b557c-a5c2-4aa9-b90a-92f18c688606,44163575,2817,2666,151,61
411,642b557c-a5c2-4aa9-b90a-92f18c688606,44163575,3245,2818,427,62
411,642b557c-a5c2-4aa9-b90a-92f18c688606,44163575,3523,3250,273,63
411,642b557c-a5c2-4aa9-b90a-92f18c688606,44163575,3815,3532,283,80
411,642b557c-a5c2-4aa9-b90a-92f18c688606,44163575,4111,3823,288,81
411,642b557c-a5c2-4aa9-b90a-92f18c688606,44163575,4332,4112,220,104
411,642b557c-a5c2-4aa9-b90a-92f18c688606,44163575,4369,4340,29,105
411,642b557c-a5c2-4aa9-b90a-92f18c688606,44163575,4547,4378,169,107
411,642b557c-a5c2-4aa9-b90a-92f18c688606,44163575,4787,4548,239,109
411,642b557c-a5c2-4aa9-b90a-92f18c688606,44163575,5584,4811,773,119
411,642b557c-a5c2-4aa9-b90a-92f18c688606,44163575,5658,5604,54,143
411,642b557c-a5c2-4aa9-b90a-92f18c688606,44163575,6103,5683,420,144
411,642b557c-a5c2-4aa9-b90a-92f18c688606,44163575,6214,6107,107,145
411,642b557c-a5c2-4aa9-b90a-92f18c688606,44163575,7089,6243,846,146
411,642b557c-a5c2-4aa9-b90a-92f18c688606,44163575,7215,6166,-1049,147
411,642b557c-a5c2-4aa9-b90a-92f18c688606,44163575,6136,5078,-1058,148
411,642b557c-a5c2-4aa9-b90a-92f18c688606,44163575,5058,4525,-533,149
411,642b557c-a5c2-4aa9-b90a-92f18c688606,44163575,4506,4254,-252,150
411,642b557c-a5c2-4aa9-b90a-92f18c688606,44163575,4720,4058,662,151
411,642b557c-a5c2-4aa9-b90a-92f18c688606,44163575,5403,4753,650,152
411,642b557c-a5c2-4aa9-b90a-92f18c688606,44163575,0,0,0,154
411,642b557c-a5c2-4aa9-b90a-92f18c688606,44163575,547,4,543,162
411,642b557c-a5c2-4aa9-b90a-92f18c688606,44163575,1934,581,1353,163
411,642b557c-a5c2-4aa9-b90a-92f18c688606,44163575,3165,1966,1199,164
411,642b557c-a5c2-4aa9-b90a-92f18c688606,44164137,72,15,57,0
411,642b557c-a5c2-4aa9-b90a-92f18c688606,44164137,58,0,-58,1
411,642b557c-a5c2-4aa9-b90a-92f18c688606,44164137,72,1,71,3
411,642b557c-a5c2-4aa9-b90a-92f18c688606,44164137,41,0,-41,6
411,642b557c-a5c2-4aa9-b90a-92f18c688606,44163141,203,8,195,0
411,642b557c-a5c2-4aa9-b90a-92f18c688606,44163141,761,243,518,1
411,642b557c-a5c2-4aa9-b90a-92f18c688606,44163141,844,768,76,2
411,642b557c-a5c2-4aa9-b90a-92f18c688606,44163141,905,849,56,3
411,642b557c-a5c2-4aa9-b90a-92f18c688606,44163141,964,907,57,4
411,642b557c-a5c2-4aa9-b90a-92f18c688606,44163141,1084,971,113,5
411,642b557c-a5c2-4aa9-b90a-92f18c688606,44163141,1236,1094,142,8
411,642b557c-a5c2-4aa9-b90a-92f18c688606,44163141,1305,1244,61,33
411,642b557c-a5c2-4aa9-b90a-92f18c688606,44163141,1665,1313,352,34
411,642b557c-a5c2-4aa9-b90a-92f18c688606,44163141,1785,1668,117,35
411,642b557c-a5c2-4aa9-b90a-92f18c688606,44163141,1876,1790,86,36
411,642b557c-a5c2-4aa9-b90a-92f18c688606,44163141,1886,1879,7,37
411,642b557c-a5c2-4aa9-b90a-92f18c688606,44163141,1911,1889,22,38
411,642b557c-a5c2-4aa9-b90a-92f18c688606,44163141,1924,1912,12,39
411,642b557c-a5c2-4aa9-b90a-92f18c688606,44163141,1958,1925,33,40
411,642b557c-a5c2-4aa9-b90a-92f18c688606,44163141,2243,1968,275,41
411,642b557c-a5c2-4aa9-b90a-92f18c688606,44163141,2497,2246,251,42
411,642b557c-a5c2-4aa9-b90a-92f18c688606,44163141,2628,2517,111,43
411,642b557c-a5c2-4aa9-b90a-92f18c688606,44152243,326,26,300,0
411,642b557c-a5c2-4aa9-b90a-92f18c688606,44152243,495,329,166,1
411,642b557c-a5c2-4aa9-b90a-92f18c688606,44152243,581,496,85,7
411,642b557c-a5c2-4aa9-b90a-92f18c688606,44152243,632,589,43,8
411,642b557c-a5c2-4aa9-b90a-92f18c688606,44152243,743,638,105,9
411,642b557c-a5c2-4aa9-b90a-92f18c688606,44152243,840,751,89,10
411,642b557c-a5c2-4aa9-b90a-92f18c688606,44152243,1148,849,299,14
411,642b557c-a5c2-4aa9-b90a-92f18c688606,44152243,1329,1154,175,16
411,642b557c-a5c2-4aa9-b90a-92f18c688606,44152243,1873,1337,536,19
411,642b557c-a5c2-4aa9-b90a-92f18c688606,44152243,2558,1881,677,20
411,642b557c-a5c2-4aa9-b90a-92f18c688606,44152243,3246,2595,651,21
411,642b557c-a5c2-4aa9-b90a-92f18c688606,44152243,4351,3279,1072,22
411,642b557c-a5c2-4aa9-b90a-92f18c688606,44152243,4686,4357,329,23
411,642b557c-a5c2-4aa9-b90a-92f18c688606,44152243,5715,4750,965,24
411,642b557c-a5c2-4aa9-b90a-92f18c688606,44143300,153,1,152,0
411,642b557c-a5c2-4aa9-b90a-92f18c688606,44143300,308,159,149,1
411,642b557c-a5c2-4aa9-b90a-92f18c688606,44143300,320,312,8,2
411,642b557c-a5c2-4aa9-b90a-92f18c688606,44143300,673,326,347,3
411,642b557c-a5c2-4aa9-b90a-92f18c688606,44143300,841,681,160,4
411,642b557c-a5c2-4aa9-b90a-92f18c688606,44143300,1138,842,296,5
411,642b557c-a5c2-4aa9-b90a-92f18c688606,44143300,1178,1146,32,6
411,642b557c-a5c2-4aa9-b90a-92f18c688606,44143300,1751,1188,563,8
411,642b557c-a5c2-4aa9-b90a-92f18c688606,44143300,1875,1769,106,9
411,642b557c-a5c2-4aa9-b90a-92f18c688606,44143300,2074,1885,189,11
411,642b557c-a5c2-4aa9-b90a-92f18c688606,44143300,2198,2079,119,16
411,642b557c-a5c2-4aa9-b90a-92f18c688606,44143300,2414,2203,211,17
411,642b557c-a5c2-4aa9-b90a-92f18c688606,44143300,2472,2420,52,18
411,642b557c-a5c2-4aa9-b90a-92f18c688606,44143300,2600,2481,119,19
411,642b557c-a5c2-4aa9-b90a-92f18c688606,44143300,2741,2602,139,20
411,642b557c-a5c2-4aa9-b90a-92f18c688606,44143300,2984,2751,233,21
411,642b557c-a5c2-4aa9-b90a-92f18c688606,44143300,3037,2985,52,22
411,642b557c-a5c2-4aa9-b90a-92f18c688606,44143300,3159,3038,121,23
411,642b557c-a5c2-4aa9-b90a-92f18c688606,44143300,3210,3167,43,24
411,642b557c-a5c2-4aa9-b90a-92f18c688606,44143300,3384,3217,167,26
411,642b557c-a5c2-4aa9-b90a-92f18c688606,44143300,3695,3389,306,27
411,642b557c-a5c2-4aa9-b90a-92f18c688606,44143300,3727,3702,25,28
411,642b557c-a5c2-4aa9-b90a-92f18c688606,44143300,3730,3729,1,29
411,642b557c-a5c2-4aa9-b90a-92f18c688606,44143300,3769,3733,36,30
411,642b557c-a5c2-4aa9-b90a-92f18c688606,44143300,3853,3786,67,31
411,642b557c-a5c2-4aa9-b90a-92f18c688606,44143300,4044,3859,185,32
412,8fe9e770-5e01-477c-9c5a-2d3bf622930c,44168094,512,60,452,0
412,8fe9e770-5e01-477c-9c5a-2d3bf622930c,44168094,561,515,46,1
412,8fe9e770-5e01-477c-9c5a-2d3bf622930c,44168094,925,595,330,10
412,8fe9e770-5e01-477c-9c5a-2d3bf622930c,44168094,1532,953,579,16
412,8fe9e770-5e01-477c-9c5a-2d3bf622930c,44168094,1964,1534,430,26
412,8fe9e770-5e01-477c-9c5a-2d3bf622930c,44168094,2345,1997,348,31
412,8fe9e770-5e01-477c-9c5a-2d3bf622930c,44168094,2652,2349,303,37
412,8fe9e770-5e01-477c-9c5a-2d3bf622930c,44168094,2883,2661,222,49
412,8fe9e770-5e01-477c-9c5a-2d3bf622930c,44168300,329,35,294,0
412,8fe9e770-5e01-477c-9c5a-2d3bf622930c,44168300,345,332,13,1
412,8fe9e770-5e01-477c-9c5a-2d3bf622930c,44168300,867,348,519,10
412,8fe9e770-5e01-477c-9c5a-2d3bf622930c,44168300,1072,895,177,11
412,8fe9e770-5e01-477c-9c5a-2d3bf622930c,44168300,1575,1088,487,12
412,8fe9e770-5e01-477c-9c5a-2d3bf622930c,44168300,2007,1598,409,13
412,8fe9e770-5e01-477c-9c5a-2d3bf622930c,44168300,2348,2055,293,14
424,fdf277d4-7457-4b0f-a9b7-b4b9a0132f6f,44167000,385,3,382,0
424,fdf277d4-7457-4b0f-a9b7-b4b9a0132f6f,44167000,749,410,339,1
424,fdf277d4-7457-4b0f-a9b7-b4b9a0132f6f,44167000,907,764,143,44
424,fdf277d4-7457-4b0f-a9b7-b4b9a0132f6f,44167000,913,913,0,134
424,fdf277d4-7457-4b0f-a9b7-b4b9a0132f6f,44167000,1085,931,154,135
424,fdf277d4-7457-4b0f-a9b7-b4b9a0132f6f,44167000,1460,1095,365,144
424,fdf277d4-7457-4b0f-a9b7-b4b9a0132f6f,44167000,1545,1471,74,145
424,fdf277d4-7457-4b0f-a9b7-b4b9a0132f6f,44167000,1611,1554,57,181
424,fdf277d4-7457-4b0f-a9b7-b4b9a0132f6f,44164430,192,9,183,0
424,fdf277d4-7457-4b0f-a9b7-b4b9a0132f6f,44164430,477,0,-477,1
424,fdf277d4-7457-4b0f-a9b7-b4b9a0132f6f,44164430,304,8,296,11
424,fdf277d4-7457-4b0f-a9b7-b4b9a0132f6f,44164430,969,317,652,12
424,fdf277d4-7457-4b0f-a9b7-b4b9a0132f6f,44164430,1403,978,425,54
424,fdf277d4-7457-4b0f-a9b7-b4b9a0132f6f,44164430,1338,912,-426,55
424,fdf277d4-7457-4b0f-a9b7-b4b9a0132f6f,44164430,1140,922,218,77
424,fdf277d4-7457-4b0f-a9b7-b4b9a0132f6f,44164430,1830,1141,689,78
424,fdf277d4-7457-4b0f-a9b7-b4b9a0132f6f,44164430,3998,1880,2118,79
424,fdf277d4-7457-4b0f-a9b7-b4b9a0132f6f,44164430,4277,4023,254,80
424,fdf277d4-7457-4b0f-a9b7-b4b9a0132f6f,44153044,284,7,277,0
424,fdf277d4-7457-4b0f-a9b7-b4b9a0132f6f,44153044,879,308,571,1
424,fdf277d4-7457-4b0f-a9b7-b4b9a0132f6f,44153044,861,747,-114,22
424,fdf277d4-7457-4b0f-a9b7-b4b9a0132f6f,44153044,738,535,-203,23
424,fdf277d4-7457-4b0f-a9b7-b4b9a0132f6f,44153044,706,534,172,24
424,fdf277d4-7457-4b0f-a9b7-b4b9a0132f6f,44153044,1131,739,392,25
424,fdf277d4-7457-4b0f-a9b7-b4b9a0132f6f,44153044,1327,1134,193,26
424,fdf277d4-7457-4b0f-a9b7-b4b9a0132f6f,44153044,1554,1349,205,27
424,fdf277d4-7457-4b0f-a9b7-b4b9a0132f6f,44153044,1786,1566,220,28
424,fdf277d4-7457-4b0f-a9b7-b4b9a0132f6f,44153044,2002,1815,187,29
424,fdf277d4-7457-4b0f-a9b7-b4b9a0132f6f,44153044,2366,2017,349,36
424,fdf277d4-7457-4b0f-a9b7-b4b9a0132f6f,44153044,2652,2375,277,37
424,fdf277d4-7457-4b0f-a9b7-b4b9a0132f6f,44153044,3289,2655,634,38
424,fdf277d4-7457-4b0f-a9b7-b4b9a0132f6f,44153044,3528,3290,238,39
424,fdf277d4-7457-4b0f-a9b7-b4b9a0132f6f,44153044,3529,3529,0,40
424,fdf277d4-7457-4b0f-a9b7-b4b9a0132f6f,44153044,3881,3600,281,43
424,fdf277d4-7457-4b0f-a9b7-b4b9a0132f6f,44141840,235,10,225,0
424,fdf277d4-7457-4b0f-a9b7-b4b9a0132f6f,44141840,781,273,508,1
424,fdf277d4-7457-4b0f-a9b7-b4b9a0132f6f,44141840,963,791,172,2
424,fdf277d4-7457-4b0f-a9b7-b4b9a0132f6f,44141840,1204,969,235,19
424,fdf277d4-7457-4b0f-a9b7-b4b9a0132f6f,44141840,1320,1220,100,20
424,fdf277d4-7457-4b0f-a9b7-b4b9a0132f6f,44141840,1517,1325,192,207
424,fdf277d4-7457-4b0f-a9b7-b4b9a0132f6f,44141840,2114,1518,596,208
424,fdf277d4-7457-4b0f-a9b7-b4b9a0132f6f,44141840,2307,2124,183,209
424,fdf277d4-7457-4b0f-a9b7-b4b9a0132f6f,44141840,2466,2311,155,210
424,fdf277d4-7457-4b0f-a9b7-b4b9a0132f6f,44141840,2830,2471,359,211
424,fdf277d4-7457-4b0f-a9b7-b4b9a0132f6f,44141840,3618,2834,784,218
424,fdf277d4-7457-4b0f-a9b7-b4b9a0132f6f,44141840,4474,3623,851,219
424,fdf277d4-7457-4b0f-a9b7-b4b9a0132f6f,44141840,4592,4488,104,220
424,fdf277d4-7457-4b0f-a9b7-b4b9a0132f6f,44141840,4654,4609,45,222
424,fdf277d4-7457-4b0f-a9b7-b4b9a0132f6f,44141840,5054,4655,399,223
424,fdf277d4-7457-4b0f-a9b7-b4b9a0132f6f,44141840,5057,4920,-137,224
424,fdf277d4-7457-4b0f-a9b7-b4b9a0132f6f,44141840,5046,4924,122,229
424,fdf277d4-7457-4b0f-a9b7-b4b9a0132f6f,44141840,5103,5047,56,230
424,fdf277d4-7457-4b0f-a9b7-b4b9a0132f6f,44141840,5142,5104,38,231
424,fdf277d4-7457-4b0f-a9b7-b4b9a0132f6f,44141840,5207,5143,64,232
424,fdf277d4-7457-4b0f-a9b7-b4b9a0132f6f,44141840,5508,5212,296,262
422,3af222e8-310c-4058-8eda-a6dc3136235e,44170122,344,10,334,0
422,3af222e8-310c-4058-8eda-a6dc3136235e,44170122,612,349,263,1
422,3af222e8-310c-4058-8eda-a6dc3136235e,44170122,692,617,75,2
422,3af222e8-310c-4058-8eda-a6dc3136235e,44170122,740,699,41,3
422,3af222e8-310c-4058-8eda-a6dc3136235e,44170122,739,728,-11,4
422,3af222e8-310c-4058-8eda-a6dc3136235e,44170122,1060,739,321,8
422,3af222e8-310c-4058-8eda-a6dc3136235e,44170122,1130,1061,69,14
422,3af222e8-310c-4058-8eda-a6dc3136235e,44170122,1311,1136,175,15
422,3af222e8-310c-4058-8eda-a6dc3136235e,44170122,1684,1324,360,18
422,3af222e8-310c-4058-8eda-a6dc3136235e,44170122,1848,1693,155,20
422,3af222e8-310c-4058-8eda-a6dc3136235e,44170122,1893,1852,41,21
422,3af222e8-310c-4058-8eda-a6dc3136235e,44170122,2076,1898,178,22
422,3af222e8-310c-4058-8eda-a6dc3136235e,44170122,2082,2079,3,23
422,3af222e8-310c-4058-8eda-a6dc3136235e,44170122,2194,2084,110,24
422,3af222e8-310c-4058-8eda-a6dc3136235e,44170122,2277,2195,82,25
422,3af222e8-310c-4058-8eda-a6dc3136235e,44170122,2302,2279,23,26
422,3af222e8-310c-4058-8eda-a6dc3136235e,44170122,2339,2305,34,29
422,3af222e8-310c-4058-8eda-a6dc3136235e,44170122,2406,2341,65,30
422,3af222e8-310c-4058-8eda-a6dc3136235e,44168602,53,5,48,0
422,3af222e8-310c-4058-8eda-a6dc3136235e,44168602,459,85,374,1
422,3af222e8-310c-4058-8eda-a6dc3136235e,44168602,592,473,119,3
422,3af222e8-310c-4058-8eda-a6dc3136235e,44168602,759,610,149,4
422,3af222e8-310c-4058-8eda-a6dc3136235e,44168602,795,765,30,5
422,3af222e8-310c-4058-8eda-a6dc3136235e,44168602,973,805,168,6
422,3af222e8-310c-4058-8eda-a6dc3136235e,44168602,1137,981,156,7
422,3af222e8-310c-4058-8eda-a6dc3136235e,44168602,1329,1141,188,9
422,3af222e8-310c-4058-8eda-a6dc3136235e,44168602,1582,1332,250,12
422,3af222e8-310c-4058-8eda-a6dc3136235e,44168602,1726,1591,135,13
422,3af222e8-310c-4058-8eda-a6dc3136235e,44168602,1860,1729,131,14
422,3af222e8-310c-4058-8eda-a6dc3136235e,44168602,1933,1867,66,15
422,3af222e8-310c-4058-8eda-a6dc3136235e,44168602,2094,1942,152,18
422,3af222e8-310c-4058-8eda-a6dc3136235e,44168602,2325,2099,226,19
422,3af222e8-310c-4058-8eda-a6dc3136235e,44168602,2596,2330,266,20
422,3af222e8-310c-4058-8eda-a6dc3136235e,44168602,2878,2618,260,21
422,3af222e8-310c-4058-8eda-a6dc3136235e,44163727,57,19,38,0
422,3af222e8-310c-4058-8eda-a6dc3136235e,44163727,189,59,130,1
422,3af222e8-310c-4058-8eda-a6dc3136235e,44163727,464,190,274,2
422,3af222e8-310c-4058-8eda-a6dc3136235e,44163727,605,480,125,3
422,3af222e8-310c-4058-8eda-a6dc3136235e,44163727,711,607,104,4
422,3af222e8-310c-4058-8eda-a6dc3136235e,44163727,965,716,249,8
422,3af222e8-310c-4058-8eda-a6dc3136235e,44163727,1025,975,50,9
422,3af222e8-310c-4058-8eda-a6dc3136235e,44163727,1053,1026,27,10
422,3af222e8-310c-4058-8eda-a6dc3136235e,44163727,1126,1055,71,11
422,3af222e8-310c-4058-8eda-a6dc3136235e,44163727,1167,1128,39,12
422,3af222e8-310c-4058-8eda-a6dc3136235e,44163727,1358,1173,185,15
422,3af222e8-310c-4058-8eda-a6dc3136235e,44163727,1454,1372,82,16
422,3af222e8-310c-4058-8eda-a6dc3136235e,44163727,1879,1456,423,17
422,3af222e8-310c-4058-8eda-a6dc3136235e,44163727,1892,1814,-78,18
422,3af222e8-310c-4058-8eda-a6dc3136235e,44163727,1870,1862,8,19
422,3af222e8-310c-4058-8eda-a6dc3136235e,44163727,2159,1884,275,25
422,3af222e8-310c-4058-8eda-a6dc3136235e,44163727,2404,2173,231,26
422,3af222e8-310c-4058-8eda-a6dc3136235e,44163727,2786,2414,372,31
422,3af222e8-310c-4058-8eda-a6dc3136235e,44163727,3069,2792,277,32
422,3af222e8-310c-4058-8eda-a6dc3136235e,44163727,3225,3019,206,33
422,3af222e8-310c-4058-8eda-a6dc3136235e,44163727,3226,3226,0,34
422,3af222e8-310c-4058-8eda-a6dc3136235e,44163727,3308,3240,68,42
422,3af222e8-310c-4058-8eda-a6dc3136235e,44163727,3505,3321,184,43
422,3af222e8-310c-4058-8eda-a6dc3136235e,44163727,3754,3506,248,44
422,3af222e8-310c-4058-8eda-a6dc3136235e,44163727,3836,3764,72,45
422,3af222e8-310c-4058-8eda-a6dc3136235e,44163727,3932,3850,82,54
422,3af222e8-310c-4058-8eda-a6dc3136235e,44163727,4152,3941,211,55
422,3af222e8-310c-4058-8eda-a6dc3136235e,44163727,4229,4159,70,56
422,3af222e8-310c-4058-8eda-a6dc3136235e,44163727,4332,4231,101,57
422,3af222e8-310c-4058-8eda-a6dc3136235e,44163727,4345,4333,12,58
422,3af222e8-310c-4058-8eda-a6dc3136235e,44163727,4594,4349,245,61
422,3af222e8-310c-4058-8eda-a6dc3136235e,44163727,4659,4595,64,63
422,3af222e8-310c-4058-8eda-a6dc3136235e,44163727,4783,4667,116,64
422,3af222e8-310c-4058-8eda-a6dc3136235e,44163727,4789,4786,3,65
422,3af222e8-310c-4058-8eda-a6dc3136235e,44163727,5027,4791,236,68
422,3af222e8-310c-4058-8eda-a6dc3136235e,44163727,5033,5029,4,69
422,3af222e8-310c-4058-8eda-a6dc3136235e,44163727,5337,5038,299,74
422,3af222e8-310c-4058-8eda-a6dc3136235e,44163727,5587,5338,249,75
422,3af222e8-310c-4058-8eda-a6dc3136235e,44163727,5779,5592,187,76
422,3af222e8-310c-4058-8eda-a6dc3136235e,44163727,5932,5794,138,82
422,3af222e8-310c-4058-8eda-a6dc3136235e,44163727,6255,5943,312,83
422,3af222e8-310c-4058-8eda-a6dc3136235e,44163727,6582,6270,312,87
422,3af222e8-310c-4058-8eda-a6dc3136235e,44163727,6622,6598,24,88
422,3af222e8-310c-4058-8eda-a6dc3136235e,44169350,104,8,96,0
422,3af222e8-310c-4058-8eda-a6dc3136235e,44169350,516,15,501,1
422,3af222e8-310c-4058-8eda-a6dc3136235e,44169350,762,526,236,2
422,3af222e8-310c-4058-8eda-a6dc3136235e,44169350,832,764,68,3
422,3af222e8-310c-4058-8eda-a6dc3136235e,44169350,834,834,0,10
422,3af222e8-310c-4058-8eda-a6dc3136235e,44169350,1089,840,249,11
422,3af222e8-310c-4058-8eda-a6dc3136235e,44169350,1264,1095,169,14
422,3af222e8-310c-4058-8eda-a6dc3136235e,44169350,1338,1273,65,15
422,3af222e8-310c-4058-8eda-a6dc3136235e,44169350,1507,1343,164,16
422,3af222e8-310c-4058-8eda-a6dc3136235e,44169350,1614,1525,89,21
422,3af222e8-310c-4058-8eda-a6dc3136235e,44169350,1794,1619,175,22
422,3af222e8-310c-4058-8eda-a6dc3136235e,44169350,1972,1797,175,23
422,3af222e8-310c-4058-8eda-a6dc3136235e,44169350,2434,1981,453,35
422,3af222e8-310c-4058-8eda-a6dc3136235e,44169350,2543,2435,108,36
422,3af222e8-310c-4058-8eda-a6dc3136235e,44169350,2550,2544,6,37
422,3af222e8-310c-4058-8eda-a6dc3136235e,44169350,2815,2558,257,42
422,3af222e8-310c-4058-8eda-a6dc3136235e,44169350,3023,2816,207,43
422,3af222e8-310c-4058-8eda-a6dc3136235e,44169350,3036,3025,11,44
422,3af222e8-310c-4058-8eda-a6dc3136235e,44169350,3184,3043,141,53
422,3af222e8-310c-4058-8eda-a6dc3136235e,44169350,3208,3187,21,54
422,3af222e8-310c-4058-8eda-a6dc3136235e,44169350,3423,3213,210,55
422,3af222e8-310c-4058-8eda-a6dc3136235e,44169350,3537,3426,111,56
422,3af222e8-310c-4058-8eda-a6dc3136235e,44169350,3572,3541,31,57
422,3af222e8-310c-4058-8eda-a6dc3136235e,44169350,3756,3589,167,64
422,3af222e8-310c-4058-8eda-a6dc3136235e,44169350,3888,3762,126,65
423,b0c25ded-18c3-4654-a57e-522c660dcac1,44173954,490,7,483,0
423,b0c25ded-18c3-4654-a57e-522c660dcac1,44173954,757,491,266,1
423,b0c25ded-18c3-4654-a57e-522c660dcac1,44173954,784,764,20,2
423,b0c25ded-18c3-4654-a57e-522c660dcac1,44173954,847,786,61,4
423,b0c25ded-18c3-4654-a57e-522c660dcac1,44173954,947,857,90,5
423,b0c25ded-18c3-4654-a57e-522c660dcac1,44173954,1411,974,437,14
423,b0c25ded-18c3-4654-a57e-522c660dcac1,44173954,1614,1416,198,19
423,b0c25ded-18c3-4654-a57e-522c660dcac1,44173954,1674,1618,56,23
423,b0c25ded-18c3-4654-a57e-522c660dcac1,44173954,1805,1684,121,24
423,b0c25ded-18c3-4654-a57e-522c660dcac1,44173954,2038,1817,221,31
423,b0c25ded-18c3-4654-a57e-522c660dcac1,44173954,2162,2050,112,37
423,b0c25ded-18c3-4654-a57e-522c660dcac1,44173954,2194,2172,22,38
423,b0c25ded-18c3-4654-a57e-522c660dcac1,44173954,2256,2205,51,40
423,b0c25ded-18c3-4654-a57e-522c660dcac1,44173954,2408,2273,135,41
423,b0c25ded-18c3-4654-a57e-522c660dcac1,44173954,2682,2426,256,49
423,b0c25ded-18c3-4654-a57e-522c660dcac1,44173954,2906,2688,218,55
423,b0c25ded-18c3-4654-a57e-522c660dcac1,44173954,3027,2909,118,56
423,b0c25ded-18c3-4654-a57e-522c660dcac1,44173954,3089,3034,55,57
423,b0c25ded-18c3-4654-a57e-522c660dcac1,44173954,3114,3091,23,58
423,b0c25ded-18c3-4654-a57e-522c660dcac1,44173954,3288,3126,162,65
423,b0c25ded-18c3-4654-a57e-522c660dcac1,44173954,3290,3290,0,66
423,b0c25ded-18c3-4654-a57e-522c660dcac1,44173954,3355,3296,59,73
423,b0c25ded-18c3-4654-a57e-522c660dcac1,44173954,3358,3357,1,74
423,b0c25ded-18c3-4654-a57e-522c660dcac1,44173954,3443,3365,78,78
423,b0c25ded-18c3-4654-a57e-522c660dcac1,44173954,3597,3457,140,85
423,b0c25ded-18c3-4654-a57e-522c660dcac1,44173954,3613,3599,14,86
423,b0c25ded-18c3-4654-a57e-522c660dcac1,44173954,3818,3615,203,91
423,b0c25ded-18c3-4654-a57e-522c660dcac1,44173954,4011,3826,185,96
423,b0c25ded-18c3-4654-a57e-522c660dcac1,44173954,4046,4024,22,100
423,b0c25ded-18c3-4654-a57e-522c660dcac1,44173954,4227,4067,160,101
423,b0c25ded-18c3-4654-a57e-522c660dcac1,44173954,4451,4230,221,103
423,b0c25ded-18c3-4654-a57e-522c660dcac1,44173954,4696,4463,233,109
423,b0c25ded-18c3-4654-a57e-522c660dcac1,44173954,4823,4703,120,112
423,b0c25ded-18c3-4654-a57e-522c660dcac1,44173954,4887,4833,54,113
423,b0c25ded-18c3-4654-a57e-522c660dcac1,44173954,5067,4899,168,122
423,b0c25ded-18c3-4654-a57e-522c660dcac1,44173954,5230,5068,162,126
423,b0c25ded-18c3-4654-a57e-522c660dcac1,44173954,5285,5238,47,131
423,b0c25ded-18c3-4654-a57e-522c660dcac1,44173954,5290,5287,3,132
423,b0c25ded-18c3-4654-a57e-522c660dcac1,44173954,5440,5306,134,139
423,b0c25ded-18c3-4654-a57e-522c660dcac1,44173954,5639,5449,190,140
423,b0c25ded-18c3-4654-a57e-522c660dcac1,44173954,5645,5368,-277,141
423,b0c25ded-18c3-4654-a57e-522c660dcac1,44173954,5606,5597,9,142
423,b0c25ded-18c3-4654-a57e-522c660dcac1,44173954,5713,5616,97,152
423,b0c25ded-18c3-4654-a57e-522c660dcac1,44173954,5752,5715,37,153
423,b0c25ded-18c3-4654-a57e-522c660dcac1,44173954,5708,5495,-213,157
423,b0c25ded-18c3-4654-a57e-522c660dcac1,44173954,5868,5595,273,158
423,b0c25ded-18c3-4654-a57e-522c660dcac1,44173954,6029,5871,158,159
423,b0c25ded-18c3-4654-a57e-522c660dcac1,44173954,6180,6053,127,161
423,b0c25ded-18c3-4654-a57e-522c660dcac1,44176899,218,3,215,0
423,b0c25ded-18c3-4654-a57e-522c660dcac1,44176899,660,237,423,3
423,b0c25ded-18c3-4654-a57e-522c660dcac1,44176899,736,662,74,4
423,b0c25ded-18c3-4654-a57e-522c660dcac1,44176899,1098,741,357,8
423,b0c25ded-18c3-4654-a57e-522c660dcac1,44176899,1033,349,-684,10
423,b0c25ded-18c3-4654-a57e-522c660dcac1,44176899,689,348,341,11
423,b0c25ded-18c3-4654-a57e-522c660dcac1,44176899,978,701,277,12
423,b0c25ded-18c3-4654-a57e-522c660dcac1,44176899,1037,981,56,13
423,b0c25ded-18c3-4654-a57e-522c660dcac1,44176899,1330,1038,292,14
423,b0c25ded-18c3-4654-a57e-522c660dcac1,44176899,1406,1335,71,15
423,b0c25ded-18c3-4654-a57e-522c660dcac1,44176899,1543,1409,134,19
423,b0c25ded-18c3-4654-a57e-522c660dcac1,44176899,1636,1535,-101,30
423,b0c25ded-18c3-4654-a57e-522c660dcac1,44176899,1516,1372,-144,33
423,b0c25ded-18c3-4654-a57e-522c660dcac1,44176899,1439,1373,66,34
423,b0c25ded-18c3-4654-a57e-522c660dcac1,44176899,1641,1452,189,38
423,b0c25ded-18c3-4654-a57e-522c660dcac1,44165718,213,4,209,0
423,b0c25ded-18c3-4654-a57e-522c660dcac1,44165718,408,224,184,1
423,b0c25ded-18c3-4654-a57e-522c660dcac1,44165718,605,417,188,2
423,b0c25ded-18c3-4654-a57e-522c660dcac1,44165718,763,330,-433,5
423,b0c25ded-18c3-4654-a57e-522c660dcac1,44165718,942,329,613,6
423,b0c25ded-18c3-4654-a57e-522c660dcac1,44165718,952,410,-542,7
423,b0c25ded-18c3-4654-a57e-522c660dcac1,44165718,949,409,540,8
423,b0c25ded-18c3-4654-a57e-522c660dcac1,44165718,1019,964,55,16
423,b0c25ded-18c3-4654-a57e-522c660dcac1,44165718,1189,1046,143,17
423,b0c25ded-18c3-4654-a57e-522c660dcac1,44165718,1344,1191,153,21
423,b0c25ded-18c3-4654-a57e-522c660dcac1,44165718,1348,1345,3,22
423,b0c25ded-18c3-4654-a57e-522c660dcac1,44165718,1532,1350,182,25
423,b0c25ded-18c3-4654-a57e-522c660dcac1,44165718,1577,1533,44,26
423,b0c25ded-18c3-4654-a57e-522c660dcac1,44165718,1649,1580,69,31
423,b0c25ded-18c3-4654-a57e-522c660dcac1,44165718,1730,1651,79,32
423,b0c25ded-18c3-4654-a57e-522c660dcac1,44165718,1826,1731,95,43
423,b0c25ded-18c3-4654-a57e-522c660dcac1,44165718,2009,1832,177,48
423,b0c25ded-18c3-4654-a57e-522c660dcac1,44165718,2068,2010,58,53
423,b0c25ded-18c3-4654-a57e-522c660dcac1,44165718,2086,2068,-18,54
423,b0c25ded-18c3-4654-a57e-522c660dcac1,44165718,2091,2069,22,55
423,b0c25ded-18c3-4654-a57e-522c660dcac1,44165718,2103,2090,13,56
423,b0c25ded-18c3-4654-a57e-522c660dcac1,44165718,2110,2104,6,57
423,b0c25ded-18c3-4654-a57e-522c660dcac1,44165718,2249,2111,138,58
423,b0c25ded-18c3-4654-a57e-522c660dcac1,44165718,2353,2252,101,64
423,b0c25ded-18c3-4654-a57e-522c660dcac1,44165718,2366,2354,12,65
423,b0c25ded-18c3-4654-a57e-522c660dcac1,44165718,2499,2375,124,68
423,b0c25ded-18c3-4654-a57e-522c660dcac1,44165718,2532,2503,29,69
423,b0c25ded-18c3-4654-a57e-522c660dcac1,44165718,2622,2534,88,73
423,b0c25ded-18c3-4654-a57e-522c660dcac1,44165718,2745,2624,121,77
423,b0c25ded-18c3-4654-a57e-522c660dcac1,44165718,2754,2747,7,78
423,b0c25ded-18c3-4654-a57e-522c660dcac1,44165718,2955,2757,198,81
423,b0c25ded-18c3-4654-a57e-522c660dcac1,44165718,3802,2961,841,85
423,b0c25ded-18c3-4654-a57e-522c660dcac1,44165718,6195,3814,2381,86
423,b0c25ded-18c3-4654-a57e-522c660dcac1,44165718,6220,6199,21,87
423,b0c25ded-18c3-4654-a57e-522c660dcac1,44166773,123,11,112,0
423,b0c25ded-18c3-4654-a57e-522c660dcac1,44166773,497,143,354,1
423,b0c25ded-18c3-4654-a57e-522c660dcac1,44166773,586,507,79,2
423,b0c25ded-18c3-4654-a57e-522c660dcac1,44166773,649,471,178,3
423,b0c25ded-18c3-4654-a57e-522c660dcac1,44166773,829,655,174,4
423,b0c25ded-18c3-4654-a57e-522c660dcac1,44166773,938,835,103,12
423,b0c25ded-18c3-4654-a57e-522c660dcac1,44166773,1035,945,90,13
423,b0c25ded-18c3-4654-a57e-522c660dcac1,44166773,1471,1058,413,21
423,b0c25ded-18c3-4654-a57e-522c660dcac1,44167000,435,4,431,0
423,b0c25ded-18c3-4654-a57e-522c660dcac1,44167000,672,438,234,1
423,b0c25ded-18c3-4654-a57e-522c660dcac1,44167000,783,676,107,2
423,b0c25ded-18c3-4654-a57e-522c660dcac1,44167000,898,790,108,3
423,b0c25ded-18c3-4654-a57e-522c660dcac1,44167000,897,897,0,4
423,b0c25ded-18c3-4654-a57e-522c660dcac1,44167000,898,898,0,12
424,62d29497-c3cf-4193-a2d3-c782885f7f56,44187718,149,149,0,0
424,62d29497-c3cf-4193-a2d3-c782885f7f56,44187718,401,155,246,1
424,62d29497-c3cf-4193-a2d3-c782885f7f56,44187718,674,407,267,2
424,62d29497-c3cf-4193-a2d3-c782885f7f56,44187718,738,684,54,3
424,62d29497-c3cf-4193-a2d3-c782885f7f56,44187718,1172,790,382,11
424,62d29497-c3cf-4193-a2d3-c782885f7f56,44187718,1409,1176,233,26
424,62d29497-c3cf-4193-a2d3-c782885f7f56,44187718,1502,1418,84,36
424,62d29497-c3cf-4193-a2d3-c782885f7f56,44187718,1707,1515,192,37
424,62d29497-c3cf-4193-a2d3-c782885f7f56,44187718,1733,1708,25,38
424,62d29497-c3cf-4193-a2d3-c782885f7f56,44187718,1895,1741,154,39
424,62d29497-c3cf-4193-a2d3-c782885f7f56,44187718,1950,1904,46,40
424,62d29497-c3cf-4193-a2d3-c782885f7f56,44187718,3722,1961,1761,149
424,62d29497-c3cf-4193-a2d3-c782885f7f56,44187718,3787,3396,-391,150
424,62d29497-c3cf-4193-a2d3-c782885f7f56,44187718,3389,3313,-76,151
424,62d29497-c3cf-4193-a2d3-c782885f7f56,44187718,3303,3261,-42,152
424,62d29497-c3cf-4193-a2d3-c782885f7f56,44187718,3368,3265,103,155
424,62d29497-c3cf-4193-a2d3-c782885f7f56,44187718,3423,3370,53,156
424,62d29497-c3cf-4193-a2d3-c782885f7f56,44187718,3610,3438,172,289
424,62d29497-c3cf-4193-a2d3-c782885f7f56,44187718,3705,3611,94,319
424,62d29497-c3cf-4193-a2d3-c782885f7f56,44187718,3862,3710,152,320
424,62d29497-c3cf-4193-a2d3-c782885f7f56,44187718,3873,3864,9,321
424,62d29497-c3cf-4193-a2d3-c782885f7f56,44187718,3865,3585,-280,341
424,62d29497-c3cf-4193-a2d3-c782885f7f56,44187718,3584,3521,-63,342
424,62d29497-c3cf-4193-a2d3-c782885f7f56,44187718,3791,3519,272,343
424,62d29497-c3cf-4193-a2d3-c782885f7f56,44187718,3975,3799,176,344
424,62d29497-c3cf-4193-a2d3-c782885f7f56,44187718,4097,3982,115,345
424,62d29497-c3cf-4193-a2d3-c782885f7f56,44187718,4607,4106,501,347
424,62d29497-c3cf-4193-a2d3-c782885f7f56,44187718,4748,4616,132,348
424,62d29497-c3cf-4193-a2d3-c782885f7f56,44187718,5101,4771,330,364
424,62d29497-c3cf-4193-a2d3-c782885f7f56,44187718,5397,5124,273,370
424,62d29497-c3cf-4193-a2d3-c782885f7f56,44187718,6734,5480,1254,371
424,62d29497-c3cf-4193-a2d3-c782885f7f56,44187718,6888,6745,143,393
424,62d29497-c3cf-4193-a2d3-c782885f7f56,44187718,6943,6889,54,394
424,62d29497-c3cf-4193-a2d3-c782885f7f56,44187718,7286,6953,333,410
424,62d29497-c3cf-4193-a2d3-c782885f7f56,44187718,7452,7288,164,411
424,62d29497-c3cf-4193-a2d3-c782885f7f56,44187718,7586,7574,12,412
424,62d29497-c3cf-4193-a2d3-c782885f7f56,44187718,7836,7590,246,414
424,62d29497-c3cf-4193-a2d3-c782885f7f56,44187718,7838,7837,1,415
424,62d29497-c3cf-4193-a2d3-c782885f7f56,44187718,7915,7841,74,421
424,62d29497-c3cf-4193-a2d3-c782885f7f56,44187718,8005,7917,88,422
424,62d29497-c3cf-4193-a2d3-c782885f7f56,44187718,8035,8006,29,423
424,62d29497-c3cf-4193-a2d3-c782885f7f56,44187718,8153,8046,107,431
424,62d29497-c3cf-4193-a2d3-c782885f7f56,44187718,8176,8154,22,432
424,62d29497-c3cf-4193-a2d3-c782885f7f56,44187718,8180,8177,3,433
424,62d29497-c3cf-4193-a2d3-c782885f7f56,44187718,8276,8181,95,442
424,62d29497-c3cf-4193-a2d3-c782885f7f56,44187718,8380,8284,96,443
424,62d29497-c3cf-4193-a2d3-c782885f7f56,44187718,8501,8382,119,444
424,62d29497-c3cf-4193-a2d3-c782885f7f56,44187718,8502,8502,0,445
424,62d29497-c3cf-4193-a2d3-c782885f7f56,44187718,8605,8504,101,446
424,62d29497-c3cf-4193-a2d3-c782885f7f56,44187718,8660,8606,54,447
424,62d29497-c3cf-4193-a2d3-c782885f7f56,44187718,8686,8661,25,448
424,62d29497-c3cf-4193-a2d3-c782885f7f56,44187718,8913,8694,219,450
424,62d29497-c3cf-4193-a2d3-c782885f7f56,44187718,9052,8916,136,451
424,62d29497-c3cf-4193-a2d3-c782885f7f56,44187718,9177,9070,107,452
424,62d29497-c3cf-4193-a2d3-c782885f7f56,44187718,9197,9178,19,453
424,62d29497-c3cf-4193-a2d3-c782885f7f56,44187718,9440,9200,240,457
424,62d29497-c3cf-4193-a2d3-c782885f7f56,44187718,9540,9444,96,458
424,62d29497-c3cf-4193-a2d3-c782885f7f56,44187718,9688,9548,140,459
424,62d29497-c3cf-4193-a2d3-c782885f7f56,44187718,10034,9696,338,460
424,62d29497-c3cf-4193-a2d3-c782885f7f56,44187718,10255,10049,206,461
424,62d29497-c3cf-4193-a2d3-c782885f7f56,44187718,10706,10263,443,464
424,62d29497-c3cf-4193-a2d3-c782885f7f56,44187718,10708,10707,1,465
424,62d29497-c3cf-4193-a2d3-c782885f7f56,44187718,11308,10753,555,470
424,62d29497-c3cf-4193-a2d3-c782885f7f56,44187718,11310,11309,1,471
424,62d29497-c3cf-4193-a2d3-c782885f7f56,44187718,11352,11352,0,1076
424,62d29497-c3cf-4193-a2d3-c782885f7f56,44160630,295,16,279,0
424,62d29497-c3cf-4193-a2d3-c782885f7f56,44160630,354,307,47,1
424,62d29497-c3cf-4193-a2d3-c782885f7f56,44160630,644,388,256,17
424,62d29497-c3cf-4193-a2d3-c782885f7f56,44160630,1328,651,677,18
424,62d29497-c3cf-4193-a2d3-c782885f7f56,44160630,1731,1332,399,58
424,62d29497-c3cf-4193-a2d3-c782885f7f56,44160630,1770,1770,0,61
424,62d29497-c3cf-4193-a2d3-c782885f7f56,44160630,2495,1821,674,62
424,62d29497-c3cf-4193-a2d3-c782885f7f56,44160630,2585,2501,84,68
424,62d29497-c3cf-4193-a2d3-c782885f7f56,44160630,2586,2586,0,69
424,62d29497-c3cf-4193-a2d3-c782885f7f56,44160630,3036,2609,427,124
424,62d29497-c3cf-4193-a2d3-c782885f7f56,44174112,448,164,284,0
424,62d29497-c3cf-4193-a2d3-c782885f7f56,44174112,660,449,211,2
424,62d29497-c3cf-4193-a2d3-c782885f7f56,44174112,825,664,161,3
424,62d29497-c3cf-4193-a2d3-c782885f7f56,44174112,994,837,157,5
424,62d29497-c3cf-4193-a2d3-c782885f7f56,44174112,1511,1023,488,22
424,62d29497-c3cf-4193-a2d3-c782885f7f56,44174112,1557,1522,35,23
424,62d29497-c3cf-4193-a2d3-c782885f7f56,44174112,1812,1568,244,26
424,62d29497-c3cf-4193-a2d3-c782885f7f56,44174112,2231,1814,417,27
411,c2ea1a50-1770-43f6-a88b-bd3d84825652,44190742,171,7,164,0
411,c2ea1a50-1770-43f6-a88b-bd3d84825652,44190742,699,179,520,1
411,c2ea1a50-1770-43f6-a88b-bd3d84825652,44190742,749,705,44,4
411,c2ea1a50-1770-43f6-a88b-bd3d84825652,44190742,820,750,70,5
411,c2ea1a50-1770-43f6-a88b-bd3d84825652,44190742,905,822,83,6
411,c2ea1a50-1770-43f6-a88b-bd3d84825652,44190742,1467,907,560,7
411,c2ea1a50-1770-43f6-a88b-bd3d84825652,44190742,1945,1495,450,8
411,c2ea1a50-1770-43f6-a88b-bd3d84825652,44190742,1963,1946,17,9
411,c2ea1a50-1770-43f6-a88b-bd3d84825652,44190742,2396,1976,420,10
411,c2ea1a50-1770-43f6-a88b-bd3d84825652,44190742,3245,2435,810,11
411,c2ea1a50-1770-43f6-a88b-bd3d84825652,44187838,303,9,294,0
411,c2ea1a50-1770-43f6-a88b-bd3d84825652,44187838,493,309,184,8
411,c2ea1a50-1770-43f6-a88b-bd3d84825652,44187838,577,497,80,25
411,c2ea1a50-1770-43f6-a88b-bd3d84825652,44187838,807,581,226,26
411,c2ea1a50-1770-43f6-a88b-bd3d84825652,44187838,923,820,103,27
411,c2ea1a50-1770-43f6-a88b-bd3d84825652,44187838,1014,932,82,28
411,c2ea1a50-1770-43f6-a88b-bd3d84825652,44187838,1128,1022,106,29
411,c2ea1a50-1770-43f6-a88b-bd3d84825652,44187838,1286,1131,155,30
411,c2ea1a50-1770-43f6-a88b-bd3d84825652,44171204,223,2,221,0
411,c2ea1a50-1770-43f6-a88b-bd3d84825652,44171204,469,228,241,1
411,c2ea1a50-1770-43f6-a88b-bd3d84825652,44171204,490,476,14,2
411,c2ea1a50-1770-43f6-a88b-bd3d84825652,44171204,621,495,126,4
411,c2ea1a50-1770-43f6-a88b-bd3d84825652,44171204,753,630,123,5
411,c2ea1a50-1770-43f6-a88b-bd3d84825652,44171204,848,757,91,6
411,c2ea1a50-1770-43f6-a88b-bd3d84825652,44171204,1090,853,237,8
411,c2ea1a50-1770-43f6-a88b-bd3d84825652,44171204,1197,1095,102,9
411,c2ea1a50-1770-43f6-a88b-bd3d84825652,44171204,1332,1203,129,10
411,c2ea1a50-1770-43f6-a88b-bd3d84825652,44171204,1549,1345,204,12
411,c2ea1a50-1770-43f6-a88b-bd3d84825652,44192297,332,5,327,0
411,c2ea1a50-1770-43f6-a88b-bd3d84825652,44192297,724,339,385,1
411,c2ea1a50-1770-43f6-a88b-bd3d84825652,44192297,930,727,203,2
411,c2ea1a50-1770-43f6-a88b-bd3d84825652,44192297,1054,932,122,18
411,c2ea1a50-1770-43f6-a88b-bd3d84825652,44192297,1237,1064,173,19
411,c2ea1a50-1770-43f6-a88b-bd3d84825652,44192297,1341,1238,103,20
411,c2ea1a50-1770-43f6-a88b-bd3d84825652,44192297,1493,1365,128,26
411,c2ea1a50-1770-43f6-a88b-bd3d84825652,44192297,1973,1533,440,27
411,c2ea1a50-1770-43f6-a88b-bd3d84825652,44192297,2044,1974,70,28
411,c2ea1a50-1770-43f6-a88b-bd3d84825652,44192297,2084,2048,36,29
411,c2ea1a50-1770-43f6-a88b-bd3d84825652,44192297,2160,2110,50,33
411,ff514263-a78c-4702-9b37-718022e7b7f6,44187718,239,3,236,0
411,ff514263-a78c-4702-9b37-718022e7b7f6,44187718,319,254,65,1
411,ff514263-a78c-4702-9b37-718022e7b7f6,44187718,609,336,273,23
411,ff514263-a78c-4702-9b37-718022e7b7f6,44187718,800,622,178,24
411,ff514263-a78c-4702-9b37-718022e7b7f6,44187718,939,815,124,25
411,ff514263-a78c-4702-9b37-718022e7b7f6,44187718,1135,955,180,27
411,ff514263-a78c-4702-9b37-718022e7b7f6,44187718,1271,1143,128,28
411,ff514263-a78c-4702-9b37-718022e7b7f6,44187718,1420,1272,148,29
411,ff514263-a78c-4702-9b37-718022e7b7f6,44187718,1690,1421,269,30
411,ff514263-a78c-4702-9b37-718022e7b7f6,44187718,2279,1691,588,31
411,ff514263-a78c-4702-9b37-718022e7b7f6,44187718,3590,2367,1223,32
411,ff514263-a78c-4702-9b37-718022e7b7f6,44187718,3783,3600,183,35
411,ff514263-a78c-4702-9b37-718022e7b7f6,44187718,4529,3811,718,36
411,ff514263-a78c-4702-9b37-718022e7b7f6,44187718,4860,4538,322,37
411,ff514263-a78c-4702-9b37-718022e7b7f6,44187718,5779,4881,898,38
411,ff514263-a78c-4702-9b37-718022e7b7f6,44187718,6633,5786,847,39
411,ff514263-a78c-4702-9b37-718022e7b7f6,44187718,6734,6641,93,40
411,ff514263-a78c-4702-9b37-718022e7b7f6,44192075,243,18,225,0
411,ff514263-a78c-4702-9b37-718022e7b7f6,44192075,1172,262,910,1
411,ff514263-a78c-4702-9b37-718022e7b7f6,44192075,1333,1173,160,2
411,ff514263-a78c-4702-9b37-718022e7b7f6,44192075,1457,1343,114,3
411,ff514263-a78c-4702-9b37-718022e7b7f6,44192075,2253,1460,793,4
411,ff514263-a78c-4702-9b37-718022e7b7f6,44192075,3026,2258,768,5
411,ff514263-a78c-4702-9b37-718022e7b7f6,44192075,4683,3030,1653,6
411,ff514263-a78c-4702-9b37-718022e7b7f6,44191444,396,27,369,0
411,ff514263-a78c-4702-9b37-718022e7b7f6,44191444,499,409,90,2
411,ff514263-a78c-4702-9b37-718022e7b7f6,44191444,545,502,43,3
411,ff514263-a78c-4702-9b37-718022e7b7f6,44191444,684,553,131,4
411,ff514263-a78c-4702-9b37-718022e7b7f6,44191444,842,688,154,5
411,ff514263-a78c-4702-9b37-718022e7b7f6,44191444,1018,860,158,6
411,ff514263-a78c-4702-9b37-718022e7b7f6,44191444,1275,1029,246,7
411,ff514263-a78c-4702-9b37-718022e7b7f6,44191444,1848,1291,557,8
411,ff514263-a78c-4702-9b37-718022e7b7f6,44191444,2082,1849,233,9
411,ff514263-a78c-4702-9b37-718022e7b7f6,44191444,2387,2084,303,10
411,ff514263-a78c-4702-9b37-718022e7b7f6,44191444,3212,2390,822,11
411,ff514263-a78c-4702-9b37-718022e7b7f6,44191444,3234,3217,17,12
411,ff514263-a78c-4702-9b37-718022e7b7f6,44191444,3873,3266,607,13
411,ff514263-a78c-4702-9b37-718022e7b7f6,44191444,4041,3906,135,14
412,1ed2425e-8ecc-4729-9163-1220984af832,44191444,661,17,644,0
412,1ed2425e-8ecc-4729-9163-1220984af832,44191444,1122,666,456,7
412,1ed2425e-8ecc-4729-9163-1220984af832,44191444,1149,1129,20,8
412,1ed2425e-8ecc-4729-9163-1220984af832,44191444,1751,1181,570,17
412,1ed2425e-8ecc-4729-9163-1220984af832,44191444,2486,1764,722,22
412,1ed2425e-8ecc-4729-9163-1220984af832,44191444,3128,2496,632,34
412,1ed2425e-8ecc-4729-9163-1220984af832,44191444,3574,3144,430,45
412,1ed2425e-8ecc-4729-9163-1220984af832,44191444,3923,3590,333,51
412,1ed2425e-8ecc-4729-9163-1220984af832,44191444,4050,3956,94,52
412,1ed2425e-8ecc-4729-9163-1220984af832,44193145,620,7,613,0
412,1ed2425e-8ecc-4729-9163-1220984af832,44193145,1178,637,541,12
412,1ed2425e-8ecc-4729-9163-1220984af832,44193145,1644,1183,461,13
412,1ed2425e-8ecc-4729-9163-1220984af832,44193145,1933,1653,280,17
412,1ed2425e-8ecc-4729-9163-1220984af832,44193145,1934,1934,0,18
412,1ed2425e-8ecc-4729-9163-1220984af832,44193145,2462,1961,501,35
412,1ed2425e-8ecc-4729-9163-1220984af832,44193145,3145,2493,652,46
412,1ed2425e-8ecc-4729-9163-1220984af832,44193145,3989,3183,806,61
412,1ed2425e-8ecc-4729-9163-1220984af832,44193145,4029,3997,32,62
412,1ed2425e-8ecc-4729-9163-1220984af832,44193145,4428,4073,355,75
422,8c5cc626-816e-427e-83ab-0955940f0ced,44190742,374,24,350,0
422,8c5cc626-816e-427e-83ab-0955940f0ced,44190742,527,377,150,1
422,8c5cc626-816e-427e-83ab-0955940f0ced,44190742,679,534,145,2
422,8c5cc626-816e-427e-83ab-0955940f0ced,44190742,837,686,151,9
422,8c5cc626-816e-427e-83ab-0955940f0ced,44190742,1091,849,242,10
422,8c5cc626-816e-427e-83ab-0955940f0ced,44190742,1218,1096,122,11
422,8c5cc626-816e-427e-83ab-0955940f0ced,44190742,1422,1219,203,14
422,8c5cc626-816e-427e-83ab-0955940f0ced,44190742,1452,1424,28,15
422,8c5cc626-816e-427e-83ab-0955940f0ced,44190742,1642,1461,181,22
422,8c5cc626-816e-427e-83ab-0955940f0ced,44190742,1726,1646,80,23
422,8c5cc626-816e-427e-83ab-0955940f0ced,44190742,1955,1729,226,24
422,8c5cc626-816e-427e-83ab-0955940f0ced,44190742,2072,1957,115,25
422,8c5cc626-816e-427e-83ab-0955940f0ced,44190742,2064,1901,-163,26
422,8c5cc626-816e-427e-83ab-0955940f0ced,44190742,2101,1942,159,27
422,8c5cc626-816e-427e-83ab-0955940f0ced,44190742,2120,2103,17,28
422,8c5cc626-816e-427e-83ab-0955940f0ced,44190742,2121,2121,0,29
422,8c5cc626-816e-427e-83ab-0955940f0ced,44190742,2167,2124,43,30
422,8c5cc626-816e-427e-83ab-0955940f0ced,44190742,2169,2168,1,31
422,8c5cc626-816e-427e-83ab-0955940f0ced,44190742,2168,2162,-6,32
422,8c5cc626-816e-427e-83ab-0955940f0ced,44190742,2312,2164,148,33
422,8c5cc626-816e-427e-83ab-0955940f0ced,44190742,2532,2337,195,34
422,8c5cc626-816e-427e-83ab-0955940f0ced,44190742,2735,2546,189,35
422,8c5cc626-816e-427e-83ab-0955940f0ced,44190742,2760,2736,24,36
422,8c5cc626-816e-427e-83ab-0955940f0ced,44190742,2954,2763,191,37
422,8c5cc626-816e-427e-83ab-0955940f0ced,44190742,3027,2916,111,38
422,8c5cc626-816e-427e-83ab-0955940f0ced,44190742,3102,3032,70,39
422,8c5cc626-816e-427e-83ab-0955940f0ced,44190742,3537,3122,415,47
422,8c5cc626-816e-427e-83ab-0955940f0ced,44190742,3617,3541,76,48
422,8c5cc626-816e-427e-83ab-0955940f0ced,44190742,3725,3620,105,53
422,8c5cc626-816e-427e-83ab-0955940f0ced,44190742,3834,3727,107,54
422,8c5cc626-816e-427e-83ab-0955940f0ced,44190742,3970,3841,129,55
422,8c5cc626-816e-427e-83ab-0955940f0ced,44190742,4274,3972,302,59
422,8c5cc626-816e-427e-83ab-0955940f0ced,44190742,4332,4277,55,60
422,8c5cc626-816e-427e-83ab-0955940f0ced,44190742,4498,4336,162,61
422,8c5cc626-816e-427e-83ab-0955940f0ced,44190742,4512,4500,12,62
422,8c5cc626-816e-427e-83ab-0955940f0ced,44190742,4621,4513,108,63
422,8c5cc626-816e-427e-83ab-0955940f0ced,44190742,4743,4622,121,64
422,8c5cc626-816e-427e-83ab-0955940f0ced,44190742,4836,4749,87,65
422,8c5cc626-816e-427e-83ab-0955940f0ced,44190742,4913,4838,75,71
422,8c5cc626-816e-427e-83ab-0955940f0ced,44190742,5188,4914,274,72
422,8c5cc626-816e-427e-83ab-0955940f0ced,44190742,5430,5189,241,73
422,8c5cc626-816e-427e-83ab-0955940f0ced,44190742,5592,5440,152,81
422,8c5cc626-816e-427e-83ab-0955940f0ced,44190742,5959,5601,358,82
422,8c5cc626-816e-427e-83ab-0955940f0ced,44190742,6215,5967,248,83
422,8c5cc626-816e-427e-83ab-0955940f0ced,44190742,6224,6218,6,84
422,8c5cc626-816e-427e-83ab-0955940f0ced,44190742,6380,6226,154,89
422,8c5cc626-816e-427e-83ab-0955940f0ced,44190742,6571,6384,187,90
422,8c5cc626-816e-427e-83ab-0955940f0ced,44190742,6699,6574,125,91
422,8c5cc626-816e-427e-83ab-0955940f0ced,44190742,6748,6701,47,92
422,8c5cc626-816e-427e-83ab-0955940f0ced,44190742,6926,6760,166,93
422,8c5cc626-816e-427e-83ab-0955940f0ced,44190742,6937,6927,10,94
422,8c5cc626-816e-427e-83ab-0955940f0ced,44190742,7097,6942,155,95
422,8c5cc626-816e-427e-83ab-0955940f0ced,44190742,7337,7099,238,96
422,8c5cc626-816e-427e-83ab-0955940f0ced,44190742,7454,7357,97,106
422,8c5cc626-816e-427e-83ab-0955940f0ced,44190742,7654,7471,183,107
422,8c5cc626-816e-427e-83ab-0955940f0ced,44190742,7826,7672,154,108
422,8c5cc626-816e-427e-83ab-0955940f0ced,44190742,7872,7827,45,109
423,81ffd00f-b5d0-4b37-b99b-77a8e2b4272e,44200621,352,1,351,0
423,81ffd00f-b5d0-4b37-b99b-77a8e2b4272e,44200621,550,369,181,1
423,81ffd00f-b5d0-4b37-b99b-77a8e2b4272e,44200621,808,559,249,2
423,81ffd00f-b5d0-4b37-b99b-77a8e2b4272e,44200621,934,810,124,3
423,81ffd00f-b5d0-4b37-b99b-77a8e2b4272e,44200621,941,836,-105,4
423,81ffd00f-b5d0-4b37-b99b-77a8e2b4272e,44200621,966,842,124,9
423,81ffd00f-b5d0-4b37-b99b-77a8e2b4272e,44200621,997,972,25,10
423,81ffd00f-b5d0-4b37-b99b-77a8e2b4272e,44200621,1158,1008,150,12
423,81ffd00f-b5d0-4b37-b99b-77a8e2b4272e,44200621,1185,1165,20,16
423,81ffd00f-b5d0-4b37-b99b-77a8e2b4272e,44200621,1279,1195,84,17
423,81ffd00f-b5d0-4b37-b99b-77a8e2b4272e,44200621,1394,1255,139,26
423,81ffd00f-b5d0-4b37-b99b-77a8e2b4272e,44200621,1686,1415,271,29
423,81ffd00f-b5d0-4b37-b99b-77a8e2b4272e,44200621,1732,1691,41,30
423,81ffd00f-b5d0-4b37-b99b-77a8e2b4272e,44200621,1765,1737,28,31
423,81ffd00f-b5d0-4b37-b99b-77a8e2b4272e,44200621,1893,1766,127,32
423,81ffd00f-b5d0-4b37-b99b-77a8e2b4272e,44200621,2005,1903,102,33
423,81ffd00f-b5d0-4b37-b99b-77a8e2b4272e,44200621,2075,2010,65,37
423,81ffd00f-b5d0-4b37-b99b-77a8e2b4272e,44200621,2180,2085,95,41
423,81ffd00f-b5d0-4b37-b99b-77a8e2b4272e,44200621,2371,2192,179,42
423,81ffd00f-b5d0-4b37-b99b-77a8e2b4272e,44200621,2534,2377,157,51
423,81ffd00f-b5d0-4b37-b99b-77a8e2b4272e,44200621,2594,2536,58,57
423,81ffd00f-b5d0-4b37-b99b-77a8e2b4272e,44200621,2644,2598,46,60
423,81ffd00f-b5d0-4b37-b99b-77a8e2b4272e,44200621,2843,2648,195,66
423,81ffd00f-b5d0-4b37-b99b-77a8e2b4272e,44200621,2908,2853,55,73
423,81ffd00f-b5d0-4b37-b99b-77a8e2b4272e,44200621,3010,2915,95,74
423,81ffd00f-b5d0-4b37-b99b-77a8e2b4272e,44200621,3112,3016,96,76
423,81ffd00f-b5d0-4b37-b99b-77a8e2b4272e,44200621,3215,3121,94,83
423,81ffd00f-b5d0-4b37-b99b-77a8e2b4272e,44200621,3249,3216,33,84
423,81ffd00f-b5d0-4b37-b99b-77a8e2b4272e,44200621,3380,3259,121,88
423,81ffd00f-b5d0-4b37-b99b-77a8e2b4272e,44200621,3476,3389,87,93
423,81ffd00f-b5d0-4b37-b99b-77a8e2b4272e,44200621,3535,3478,57,94
423,81ffd00f-b5d0-4b37-b99b-77a8e2b4272e,44200621,3592,3542,50,95
423,81ffd00f-b5d0-4b37-b99b-77a8e2b4272e,44200621,3657,3603,54,97
423,81ffd00f-b5d0-4b37-b99b-77a8e2b4272e,44200621,3678,3658,20,98
423,81ffd00f-b5d0-4b37-b99b-77a8e2b4272e,44200621,3722,3683,39,104
423,81ffd00f-b5d0-4b37-b99b-77a8e2b4272e,44200621,3801,3730,71,106
423,81ffd00f-b5d0-4b37-b99b-77a8e2b4272e,44200621,3841,3812,29,107
423,81ffd00f-b5d0-4b37-b99b-77a8e2b4272e,44200621,3945,3847,98,110
423,81ffd00f-b5d0-4b37-b99b-77a8e2b4272e,44200621,3951,3951,0,115
423,81ffd00f-b5d0-4b37-b99b-77a8e2b4272e,44200621,4078,3960,118,116
423,81ffd00f-b5d0-4b37-b99b-77a8e2b4272e,44200621,4168,4084,84,117
423,81ffd00f-b5d0-4b37-b99b-77a8e2b4272e,44200621,4178,4178,0,123
423,81ffd00f-b5d0-4b37-b99b-77a8e2b4272e,44200621,4357,4188,169,124
423,81ffd00f-b5d0-4b37-b99b-77a8e2b4272e,44200621,4493,4363,130,133
423,81ffd00f-b5d0-4b37-b99b-77a8e2b4272e,44200621,4695,4494,201,136
423,81ffd00f-b5d0-4b37-b99b-77a8e2b4272e,44200621,4704,4696,8,137
423,81ffd00f-b5d0-4b37-b99b-77a8e2b4272e,44200621,4814,4710,104,138
423,81ffd00f-b5d0-4b37-b99b-77a8e2b4272e,44200621,4834,4815,19,139
423,81ffd00f-b5d0-4b37-b99b-77a8e2b4272e,44200621,4844,4825,-19,140
423,81ffd00f-b5d0-4b37-b99b-77a8e2b4272e,44200621,4950,4832,118,150
423,81ffd00f-b5d0-4b37-b99b-77a8e2b4272e,44200621,5102,4952,150,156
423,81ffd00f-b5d0-4b37-b99b-77a8e2b4272e,44200621,5202,5114,88,158
423,81ffd00f-b5d0-4b37-b99b-77a8e2b4272e,44200621,5287,5203,84,165
423,81ffd00f-b5d0-4b37-b99b-77a8e2b4272e,44200621,5370,5294,76,174
423,81ffd00f-b5d0-4b37-b99b-77a8e2b4272e,44200621,5412,5371,41,175
423,81ffd00f-b5d0-4b37-b99b-77a8e2b4272e,44200621,5447,5418,29,178
423,81ffd00f-b5d0-4b37-b99b-77a8e2b4272e,44200621,5543,5455,88,179
423,81ffd00f-b5d0-4b37-b99b-77a8e2b4272e,44200621,5527,5327,-200,180
423,81ffd00f-b5d0-4b37-b99b-77a8e2b4272e,44200621,5396,5333,63,181
423,81ffd00f-b5d0-4b37-b99b-77a8e2b4272e,44200621,5533,5397,136,182
423,81ffd00f-b5d0-4b37-b99b-77a8e2b4272e,44200621,5592,5534,58,183
423,81ffd00f-b5d0-4b37-b99b-77a8e2b4272e,44200621,5754,5596,158,188
423,81ffd00f-b5d0-4b37-b99b-77a8e2b4272e,44200621,5870,5761,109,189
423,81ffd00f-b5d0-4b37-b99b-77a8e2b4272e,44200621,5786,5763,-23,190
423,81ffd00f-b5d0-4b37-b99b-77a8e2b4272e,44200621,5862,5767,95,197
423,81ffd00f-b5d0-4b37-b99b-77a8e2b4272e,44200621,6014,5872,142,199
423,81ffd00f-b5d0-4b37-b99b-77a8e2b4272e,44200621,6179,6022,157,200
423,81ffd00f-b5d0-4b37-b99b-77a8e2b4272e,44200621,6216,6182,34,201
423,81ffd00f-b5d0-4b37-b99b-77a8e2b4272e,44200621,6728,6219,509,203
423,81ffd00f-b5d0-4b37-b99b-77a8e2b4272e,44200621,6787,6740,47,204
423,81ffd00f-b5d0-4b37-b99b-77a8e2b4272e,44200621,7032,6790,242,205
423,81ffd00f-b5d0-4b37-b99b-77a8e2b4272e,44200621,7231,7042,189,211
423,81ffd00f-b5d0-4b37-b99b-77a8e2b4272e,44200621,7357,7238,119,214
423,81ffd00f-b5d0-4b37-b99b-77a8e2b4272e,44200621,7523,7384,139,226
423,81ffd00f-b5d0-4b37-b99b-77a8e2b4272e,44200621,7556,7524,32,227
423,81ffd00f-b5d0-4b37-b99b-77a8e2b4272e,44200621,7597,7557,40,228
423,81ffd00f-b5d0-4b37-b99b-77a8e2b4272e,44200621,7712,7601,111,230
423,81ffd00f-b5d0-4b37-b99b-77a8e2b4272e,44200621,7757,7714,43,231
423,81ffd00f-b5d0-4b37-b99b-77a8e2b4272e,44200621,7806,7765,41,232
423,81ffd00f-b5d0-4b37-b99b-77a8e2b4272e,44200621,7962,7817,145,233
423,81ffd00f-b5d0-4b37-b99b-77a8e2b4272e,44200621,8067,7968,99,234
423,81ffd00f-b5d0-4b37-b99b-77a8e2b4272e,44202102,291,16,275,0
423,81ffd00f-b5d0-4b37-b99b-77a8e2b4272e,44202102,578,297,281,1
423,81ffd00f-b5d0-4b37-b99b-77a8e2b4272e,44202102,669,579,90,2
423,81ffd00f-b5d0-4b37-b99b-77a8e2b4272e,44202102,823,683,140,3
423,81ffd00f-b5d0-4b37-b99b-77a8e2b4272e,44202102,1056,826,230,4
423,81ffd00f-b5d0-4b37-b99b-77a8e2b4272e,44202102,1260,1057,203,5
423,81ffd00f-b5d0-4b37-b99b-77a8e2b4272e,44202102,1486,1269,217,6
423,81ffd00f-b5d0-4b37-b99b-77a8e2b4272e,44202102,1591,1487,104,7
423,81ffd00f-b5d0-4b37-b99b-77a8e2b4272e,44203679,603,3,600,0
423,81ffd00f-b5d0-4b37-b99b-77a8e2b4272e,44203679,1020,636,384,1
423,81ffd00f-b5d0-4b37-b99b-77a8e2b4272e,44203679,1191,1026,165,2
423,81ffd00f-b5d0-4b37-b99b-77a8e2b4272e,44203679,1297,1194,103,3
423,81ffd00f-b5d0-4b37-b99b-77a8e2b4272e,44203679,1403,1303,100,5
423,81ffd00f-b5d0-4b37-b99b-77a8e2b4272e,44203679,1424,1405,19,6
423,81ffd00f-b5d0-4b37-b99b-77a8e2b4272e,44203679,1540,1428,112,13
423,81ffd00f-b5d0-4b37-b99b-77a8e2b4272e,44203679,1569,1541,28,14
423,81ffd00f-b5d0-4b37-b99b-77a8e2b4272e,44203679,1687,1573,114,25
423,81ffd00f-b5d0-4b37-b99b-77a8e2b4272e,44203679,1734,1698,36,40
423,81ffd00f-b5d0-4b37-b99b-77a8e2b4272e,44203679,1816,1743,73,41
423,81ffd00f-b5d0-4b37-b99b-77a8e2b4272e,44203679,1849,1817,32,45
423,81ffd00f-b5d0-4b37-b99b-77a8e2b4272e,44203679,1906,1859,47,46
423,81ffd00f-b5d0-4b37-b99b-77a8e2b4272e,44203679,2354,1912,442,49
423,81ffd00f-b5d0-4b37-b99b-77a8e2b4272e,44195948,670,21,649,0
423,81ffd00f-b5d0-4b37-b99b-77a8e2b4272e,44195948,995,681,314,1
423,81ffd00f-b5d0-4b37-b99b-77a8e2b4272e,44195948,1189,998,191,11
423,81ffd00f-b5d0-4b37-b99b-77a8e2b4272e,44195948,1336,1192,144,21
423,81ffd00f-b5d0-4b37-b99b-77a8e2b4272e,44195948,1367,1337,30,22
423,81ffd00f-b5d0-4b37-b99b-77a8e2b4272e,44195948,1422,1372,50,44
423,81ffd00f-b5d0-4b37-b99b-77a8e2b4272e,44195948,1454,1427,27,45
423,81ffd00f-b5d0-4b37-b99b-77a8e2b4272e,44195948,1562,1455,107,56
423,81ffd00f-b5d0-4b37-b99b-77a8e2b4272e,44195948,2801,1567,1234,74
423,81ffd00f-b5d0-4b37-b99b-77a8e2b4272e,44195948,3828,2867,961,75
423,81ffd00f-b5d0-4b37-b99b-77a8e2b4272e,44202312,326,4,322,0
423,81ffd00f-b5d0-4b37-b99b-77a8e2b4272e,44202312,461,333,128,1
423,81ffd00f-b5d0-4b37-b99b-77a8e2b4272e,44202312,924,469,455,4
423,81ffd00f-b5d0-4b37-b99b-77a8e2b4272e,44202312,954,931,23,5
423,81ffd00f-b5d0-4b37-b99b-77a8e2b4272e,44202312,1246,1001,245,7
423,81ffd00f-b5d0-4b37-b99b-77a8e2b4272e,44202312,1788,1255,533,11
423,81ffd00f-b5d0-4b37-b99b-77a8e2b4272e,44202312,1996,1813,183,12
423,81ffd00f-b5d0-4b37-b99b-77a8e2b4272e,44202312,2592,2027,565,13
423,81ffd00f-b5d0-4b37-b99b-77a8e2b4272e,44202312,5103,2629,2474,14
423,81ffd00f-b5d0-4b37-b99b-77a8e2b4272e,44202312,5266,5152,114,15
424,82014d60-826c-4956-892f-0e437e1ed2a2,44199844,531,4,527,0
424,82014d60-826c-4956-892f-0e437e1ed2a2,44199844,547,535,12,1
424,82014d60-826c-4956-892f-0e437e1ed2a2,44199844,977,558,419,6
424,82014d60-826c-4956-892f-0e437e1ed2a2,44199844,1148,982,166,20
424,82014d60-826c-4956-892f-0e437e1ed2a2,44199844,1644,1200,444,21
424,82014d60-826c-4956-892f-0e437e1ed2a2,44199844,1728,1652,76,22
424,82014d60-826c-4956-892f-0e437e1ed2a2,44199844,1821,1732,89,33
424,82014d60-826c-4956-892f-0e437e1ed2a2,44199844,1911,1828,83,34
424,82014d60-826c-4956-892f-0e437e1ed2a2,44199844,1983,1914,69,53
424,82014d60-826c-4956-892f-0e437e1ed2a2,44199844,2164,2003,161,55
424,82014d60-826c-4956-892f-0e437e1ed2a2,44199844,2176,2168,8,56
424,82014d60-826c-4956-892f-0e437e1ed2a2,44199844,2620,2184,436,162
424,82014d60-826c-4956-892f-0e437e1ed2a2,44199844,2777,2634,143,163
424,82014d60-826c-4956-892f-0e437e1ed2a2,44199844,3162,2782,380,173
424,82014d60-826c-4956-892f-0e437e1ed2a2,44199844,3427,3182,245,192
424,82014d60-826c-4956-892f-0e437e1ed2a2,44199844,3573,3449,124,193
424,82014d60-826c-4956-892f-0e437e1ed2a2,44199844,3984,3574,410,204
424,82014d60-826c-4956-892f-0e437e1ed2a2,44199844,4130,4129,1,205
424,82014d60-826c-4956-892f-0e437e1ed2a2,44199844,4355,4133,222,228
424,82014d60-826c-4956-892f-0e437e1ed2a2,44199844,4389,4364,25,229
424,82014d60-826c-4956-892f-0e437e1ed2a2,44199844,4971,4397,574,251
424,82014d60-826c-4956-892f-0e437e1ed2a2,44199844,5128,5078,50,259
424,82014d60-826c-4956-892f-0e437e1ed2a2,44199844,5828,5165,663,260
424,82014d60-826c-4956-892f-0e437e1ed2a2,44199844,6387,5829,558,261
424,82014d60-826c-4956-892f-0e437e1ed2a2,44199844,6909,6425,484,262
424,82014d60-826c-4956-892f-0e437e1ed2a2,44197118,195,4,191,0
424,82014d60-826c-4956-892f-0e437e1ed2a2,44197118,286,214,72,1
424,82014d60-826c-4956-892f-0e437e1ed2a2,44197118,402,302,100,2
424,82014d60-826c-4956-892f-0e437e1ed2a2,44197118,664,406,258,3
424,82014d60-826c-4956-892f-0e437e1ed2a2,44197118,830,675,155,18
424,82014d60-826c-4956-892f-0e437e1ed2a2,44197118,1033,846,187,33
424,82014d60-826c-4956-892f-0e437e1ed2a2,44197118,1182,1043,139,47
424,82014d60-826c-4956-892f-0e437e1ed2a2,44197118,1186,1183,3,48
424,82014d60-826c-4956-892f-0e437e1ed2a2,44197118,1659,1187,472,53
424,82014d60-826c-4956-892f-0e437e1ed2a2,44197118,1684,1665,19,54
424,82014d60-826c-4956-892f-0e437e1ed2a2,44197118,1863,1685,178,65
424,82014d60-826c-4956-892f-0e437e1ed2a2,44197118,2120,1867,253,71
424,82014d60-826c-4956-892f-0e437e1ed2a2,44197118,2124,2121,3,72
424,82014d60-826c-4956-892f-0e437e1ed2a2,44197118,2644,2129,515,90
424,82014d60-826c-4956-892f-0e437e1ed2a2,44197118,2688,2652,36,100
424,82014d60-826c-4956-892f-0e437e1ed2a2,44197118,2846,2697,149,101
424,82014d60-826c-4956-892f-0e437e1ed2a2,44197118,2992,2862,130,105
424,82014d60-826c-4956-892f-0e437e1ed2a2,44197118,3529,3007,522,116
424,82014d60-826c-4956-892f-0e437e1ed2a2,44197118,3904,3572,332,118
424,82014d60-826c-4956-892f-0e437e1ed2a2,44197118,3945,3912,33,119
424,82014d60-826c-4956-892f-0e437e1ed2a2,44197118,4278,3963,315,122
424,82014d60-826c-4956-892f-0e437e1ed2a2,44200041,234,12,222,0
424,82014d60-826c-4956-892f-0e437e1ed2a2,44200041,379,250,129,3
424,82014d60-826c-4956-892f-0e437e1ed2a2,44200041,667,401,266,4
424,82014d60-826c-4956-892f-0e437e1ed2a2,44200041,1031,700,331,9
424,82014d60-826c-4956-892f-0e437e1ed2a2,44200041,1467,1096,371,23
424,82014d60-826c-4956-892f-0e437e1ed2a2,44200041,2258,1480,778,24
424,82014d60-826c-4956-892f-0e437e1ed2a2,44200041,2442,2264,178,79
424,82014d60-826c-4956-892f-0e437e1ed2a2,44200041,2660,2443,217,80
424,82014d60-826c-4956-892f-0e437e1ed2a2,44200041,2998,2669,329,83
424,82014d60-826c-4956-892f-0e437e1ed2a2,44200041,3483,3009,474,86
424,82014d60-826c-4956-892f-0e437e1ed2a2,44200041,3501,3487,14,87
424,82014d60-826c-4956-892f-0e437e1ed2a2,44200041,3711,3517,194,90
424,82014d60-826c-4956-892f-0e437e1ed2a2,44200041,0,0,0,94
424,82014d60-826c-4956-892f-0e437e1ed2a2,44200041,1586,69,1517,392
424,82014d60-826c-4956-892f-0e437e1ed2a2,44200041,4689,1732,2957,393
424,82014d60-826c-4956-892f-0e437e1ed2a2,44200041,4072,0,-4072,394
424,82014d60-826c-4956-892f-0e437e1ed2a2,44200041,3318,84,3234,482
424,82014d60-826c-4956-892f-0e437e1ed2a2,44200041,3376,2958,418,483
424,82014d60-826c-4956-892f-0e437e1ed2a2,44200041,3809,3387,422,484
424,82014d60-826c-4956-892f-0e437e1ed2a2,44200041,0,0,0,485
424,82014d60-826c-4956-892f-0e437e1ed2a2,44200041,2273,32,2241,497
424,82014d60-826c-4956-892f-0e437e1ed2a2,44200041,3697,2306,1391,498
424,82014d60-826c-4956-892f-0e437e1ed2a2,44200041,3702,3529,-173,499
424,82014d60-826c-4956-892f-0e437e1ed2a2,44200041,0,0,0,560
402,56352eb9-0016-485b-ab29-174ff1349ac2,44705158,610,43,567,0
402,56352eb9-0016-485b-ab29-174ff1349ac2,44705158,642,616,26,1
402,56352eb9-0016-485b-ab29-174ff1349ac2,44705158,978,671,307,4
402,56352eb9-0016-485b-ab29-174ff1349ac2,44705158,1146,973,173,12
402,56352eb9-0016-485b-ab29-174ff1349ac2,44705158,2562,1200,1362,13
402,56352eb9-0016-485b-ab29-174ff1349ac2,44705158,2604,2573,31,14
427,2b92b40e-373e-4dde-9c55-6534f88f8574,44771792,896,18,878,0
427,2b92b40e-373e-4dde-9c55-6534f88f8574,44771792,4608,958,3650,1
427,2b92b40e-373e-4dde-9c55-6534f88f8574,44758589,1134,16,1118,0
427,2b92b40e-373e-4dde-9c55-6534f88f8574,44758589,5503,1309,4194,1
427,2b92b40e-373e-4dde-9c55-6534f88f8574,44758589,4241,0,-4241,2
427,2b92b40e-373e-4dde-9c55-6534f88f8574,44758589,7893,17,7876,5
428,eb35eeac-f294-44a4-ae4a-f4472c04f268,45462999,267,2,265,0
428,eb35eeac-f294-44a4-ae4a-f4472c04f268,45462999,346,278,68,1
428,eb35eeac-f294-44a4-ae4a-f4472c04f268,45462999,330,0,-330,33
428,eb35eeac-f294-44a4-ae4a-f4472c04f268,45445554,21,2,19,0
428,eb35eeac-f294-44a4-ae4a-f4472c04f268,45445554,657,34,623,1
428,eb35eeac-f294-44a4-ae4a-f4472c04f268,45445554,1365,667,698,2
428,eb35eeac-f294-44a4-ae4a-f4472c04f268,45445554,1565,1374,191,3
428,eb35eeac-f294-44a4-ae4a-f4472c04f268,45445554,1684,1567,117,5
428,eb35eeac-f294-44a4-ae4a-f4472c04f268,45445554,1717,1687,30,6
428,eb35eeac-f294-44a4-ae4a-f4472c04f268,45445554,1847,1719,128,14
428,eb35eeac-f294-44a4-ae4a-f4472c04f268,45445554,1848,1848,0,15
428,eb35eeac-f294-44a4-ae4a-f4472c04f268,45445554,1848,1733,115,48
428,eb35eeac-f294-44a4-ae4a-f4472c04f268,45445554,1840,994,-846,71
428,eb35eeac-f294-44a4-ae4a-f4472c04f268,45445554,823,0,-823,72
